Bank reference,Narrative,Customer reference,TRN type,Value date,Credit amount,Debit amount,Time,Post date,Balance
829471Z01W0W,HELLMANN SAUDI ARABIA TFR+,INV241221276270,Transfer,31/12/2024,"5,444.10",,19:05,31/12/2024,"20,784,406.54"
71307250006L,SAUDI TECHNOLOGY COMPANY TFR+,NONREF,Transfer,31/12/2024,"2,849,355.00",,18:55,31/12/2024,"20,778,962.44"
EBPZ-07262,FROM SADEEM TECHNOLOGY F فواتير سﻼم,NONREF,Transfer,31/12/2024,"32,704.55",,15:44,31/12/2024,"17,929,607.44"
YRTI-33922,LP IPSP2400MMFO3 شركه قنوات للنظم SA7480000166608010291995 Alrajhi Bank RIYADH 20241231SARJHIRJHI6BOPF11522045594 31DEC24 15:22:47,NONREF,Transfer,31/12/2024,"8,646.52",,15:22,31/12/2024,"17,896,902.89"
1914726016L7,ARABIAN I.+.S.CO.LTD TFR+,NONREF,Transfer,31/12/2024,"21,238.20",,15:06,31/12/2024,"17,888,256.37"
NCBK82424366AUJW,ركة الحفر والخدمات البتروليةالمحدو والخدمات البتروليةالمحدو Operating Expenses TFR+ Operational Maintenance NATIONAL COMMERCIAL BANK NATIONAL COMMERCIAL BANK EX Rate : SAR 1.0000000,NONREF,Transfer,31/12/2024,"30,049.50",,14:54,31/12/2024,"17,867,018.17"
YRTI-32098,LP IPSP2400MM5YU ريبون العالمية للتجارة SA5405000068200855550000 Alinma bank RIYADH 20241231SAINMAINMA6BXXX11451275619 31DEC24 14:51:42,NONREF,Transfer,31/12/2024,"7,935.00",,14:51,31/12/2024,"17,836,968.67"
132072600SOZ,ABDUL LATIF JAMEEL SUMMI TFR+,INTERNET,Transfer,31/12/2024,"33,120.00",,14:45,31/12/2024,"17,829,033.67"
NCBK82424366ATIG,SAUDI FAL CO LTD TFR+ Service/Utility Bills BPV12-40783 BPV12-40783 NATIONAL COMMERCIAL BANK NATIONAL COMMERCIAL BANK EX Rate : SAR 1.0000000,NONREF,Transfer,31/12/2024,"107,640.00",,14:26,31/12/2024,"17,795,913.67"
010141231H006275,Company MAJMOU BAAN Holding Company MAJMOU BAAN Hold Scheduled Dec 24 Payment TFR+ Hotels SAUDI INVESTMENT BANK RIYADH EX Rate : SAR 1.0000000,NONREF,Transfer,31/12/2024,"332,831.55",,14:26,31/12/2024,"17,688,273.67"
YRTI-29524,LP IPSP2400MM0O7 ة الشرق للخرسانه الجاهزه SA1080000572608010009007 Alrajhi Bank RIYADH 20241231SARJHIRJHI6BOPF11408873752 31DEC24 14:08:43,NONREF,Transfer,31/12/2024,"14,490.00",,14:08,31/12/2024,"17,355,442.12"
5.00003E+11,INTERCONTINENTAL AL KHOBAR HOTEL INTERCONTINENTAL AL KHOB INTB0249524262730654853E TFR+ AL RAJHI BANKING AND INV T CORP HEAD OFFICE RIYADH EX Rate : SAR 1.0000000,NONREF,Transfer,31/12/2024,"49,335.00",,13:14,31/12/2024,"17,340,952.12"
NCBK82424366APQE,)ركة انفال الادارية )شركة شخص واحد )الادارية )شركة شخص واحد مصاريف تشغيل TFR+ فواتير خدمات NATIONAL COMMERCIAL BANK NATIONAL COMMERCIAL BANK EX Rate : SAR 1.0000000,NONREF,Transfer,31/12/2024,"5,661.45",,12:38,31/12/2024,"17,291,617.12"
NCBK82424366AOQV,ركة حمد بن عبدالله بن سليمان المني عبدالله بن سليمان المني مصاريف تشغيل TFR+ فواتير خدمات NATIONAL COMMERCIAL BANK NATIONAL COMMERCIAL BANK EX Rate : SAR 1.0000000,NONREF,Transfer,31/12/2024,"18,030.85",,12:02,31/12/2024,"17,285,955.67"
NCBK82424366AOPF,شركة الاعتصام الخليجي للتجاره الاعتصام الخليجي للتجاره Operating Expenses TFR+ Operational Maintenance NATIONAL COMMERCIAL BANK NATIONAL COMMERCIAL BANK EX Rate : SAR 1.0000000,NONREF,Transfer,31/12/2024,"49,337.89",,12:02,31/12/2024,"17,267,924.82"
YRTI-22263,LP IPSP2400MLK07 OPTIMAL TECHNOLOGY SOLUT SA2080000446608016066666 Alrajhi Bank RIYADH 20241231SARJHIRJHI6BOPF11201632614 31DEC24 12:01:52,NONREF,Transfer,31/12/2024,"15,065.00",,12:01,31/12/2024,"17,218,586.93"
NCBK9812436404FP,MUWAZANA FINANCIAL LIMITED MUWAZANA FINANCIAL LIMIT 0101INVOICE PAYMENT AND TFR+ NATIONAL COMMERCIAL BANK NATIONAL COMMERCIAL BANK EX Rate : SAR 1.0000000 JO42UBSI1010000015465574215101,NONREF,Transfer,31/12/2024,"22,782.44",,11:52,31/12/2024,"17,203,521.93"
P134009641EBPLUS,ARABTECH JARDANEH AND PARTNERS ENG ARABTECH JARDANEH AND PA COMPANIES FOR OTHER PURP TFR+ Q4 2024 invoices ARAB NATIONAL BANK RIYADH BRANCH EX Rate : SAR 1.0000000,NONREF,Transfer,31/12/2024,"70,036.23",,11:13,31/12/2024,"17,180,739.49"
NCBK82424366ALCC,شركة ايوان الضيافة لتشغيل الفنادق TFR+ فواتير خدمات NATIONAL COMMERCIAL BANK NATIONAL COMMERCIAL BANK EX Rate : SAR 1.0000000 65900000637103 TRF FROM:SAUDI ARABIA,NONREF,Transfer,31/12/2024,"66,804.64",,11:06,31/12/2024,"17,110,703.26"
EPHR98124366FVB2,SULZER SAUDI PUMP COMPANY TFR+ BANQUE SAUDI FRANSI HEAD OFFICE RIYADH EX Rate : SAR 1.0000000 SA5655000000040217100160 TRF FROM:SAUDI ARABIA 3918 14334,NONREF,Transfer,31/12/2024,"217,280.75",,11:01,31/12/2024,"17,043,898.62"
YRTI-18673,LP IPSP2400MLD91 شركة شقران الوقفية SA3205000068203472662000 Alinma bank RIYADH 20241231SAINMAINMA6BXXX11059254085 31DEC24 11:00:12,NONREF,Transfer,31/12/2024,"1,207.50",,11:00,31/12/2024,"16,826,617.87"
5.00003E+11,JAMEAT ZAMZM /33/Repayment of Loans TFR+ INTB0041814773770000359E4C317369 AL RAJHI BANKING AND INV T CORP HEAD OFFICE RIYADH EX Rate : SAR 1.0000000 SA1980000377608010000359,NONREF,Transfer,31/12/2024,"81,227.64",,10:53,31/12/2024,"16,825,410.37"
9466836609512YXD,شركة مداد للحلول المكتبية المحدودة للحلول المكتبية المحدودة الفواتير / مشتريات TFR+ invoices 41 invoices RIYAD BANK HEAD OFFICE RIYADH,NONREF,Transfer,31/12/2024,"419,190.90",,10:51,31/12/2024,"16,744,182.73"
9466836509512XSA,فندق حياة بلايس الرياض بالسليماني بلايس الرياض بالسليماني Purchase/expenses/Hotel TFR+ 104833 104834 RIYAD BANK HEAD OFFICE RIYADH EX Rate : SAR 1.0000000,NONREF,Transfer,31/12/2024,"131,276.87",,10:42,31/12/2024,"16,324,991.83"
FT24365138820870,ALBILAD INVESTMENT COMPANY ALBILAD INVESTMENT COMPA SETTLEMENT OF BILLS TFR+ NO INV0045987 TELEPHONE FEES BANK AL BILAD BANK AL BILAD EX Rate : SAR 1.0000000,NONREF,Transfer,31/12/2024,"15,295.64",,10:36,31/12/2024,"16,193,714.96"
7.08902E+13,HUMAN RESOUACES DEVELOPMENT FUND HUMAN RESOUACES DEVELOPM /BONUS/ TFR+ ARAB NATIONAL BANK RIYADH BRANCH EX Rate : SAR 1.0000000 UMAN RESOUACES DEVELOPMENT FUND,NONREF,Transfer,31/12/2024,"9,000.00",,10:36,31/12/2024,"16,178,419.32"
7.08902E+13,HUMAN RESOUACES DEVELOPMENT FUND HUMAN RESOUACES DEVELOPM /BONUS/ TFR+ ARAB NATIONAL BANK RIYADH BRANCH EX Rate : SAR 1.0000000 UMAN RESOUACES DEVELOPMENT FUND,NONREF,Transfer,31/12/2024,"109,630.00",,10:36,31/12/2024,"16,169,419.32"
7.08902E+13,HUMAN RESOUACES DEVELOPMENT FUND HUMAN RESOUACES DEVELOPM /BONUS/ TFR+ ARAB NATIONAL BANK RIYADH BRANCH EX Rate : SAR 1.0000000 UMAN RESOUACES DEVELOPMENT FUND,NONREF,Transfer,31/12/2024,"18,000.00",,10:28,31/12/2024,"16,059,789.32"
300972100FYB,ALIMTYAZ ALRIYADI TFR+ 2ND PAYMENT AUG-24,SALAM 2ND AUG,Transfer,31/12/2024,"22,316.04",,10:26,31/12/2024,"16,041,789.32"
YRTI-12302,LP IPSP2400ML0UJ MADARAT COMPANY SA5680000362608018899999 Alrajhi Bank RIYADH 20241231SARJHIRJHI6BOPF10855329842 31DEC24 08:55:46,NONREF,Transfer,31/12/2024,"13,196.25",,8:55,31/12/2024,"16,019,473.28"
YRTI-12042,LP IPSP2400MKZTO مات الصحيه التطوعيه بجده SA1980000377608010000359 Alrajhi Bank RIYADH 20241231SARJHIRJHI6BOPF10846315626 31DEC24 08:47:06,NONREF,Transfer,31/12/2024,"9,662.69",,8:47,31/12/2024,"16,006,277.03"
YRTI-05824,LP IPSP2400MKMCN اﻻت و تق نية المعلومات SA7910000012347102005802 Saudi National Bank JEDDAH 20241231SANCBKNCBK6B82410052877960 31DEC24 00:53:16,NONREF,Transfer,31/12/2024,"7,080.00",,0:53,31/12/2024,"15,996,614.34"
YRTI-51276,LP IPSP2400MK366 ELECTRICAL AND POWER CON SA9730400108095222420010 Arab National Bank RIYADH 20241230SAARNBARNB1B93712045554426 30DEC24 20:45:27,NONREF,Transfer,30/12/2024,"11,202.15",,20:45,30/12/2024,"15,989,534.34"
677872501QV3,ACE GALLAGHER ARABIA CO TFR+,SALAM INVOICES,Transfer,30/12/2024,"402,615.00",,16:42,30/12/2024,"15,978,332.19"
868672300S9E,SELA COMPANY TFR+,"PHONUSAGEOCT,NOV",Transfer,30/12/2024,"15,583.72",,15:12,30/12/2024,"15,575,717.19"
9466836509512VC8,شركة زهير فايز ومشاركوه للاستشارات فايز ومشاركوه للاستشارات expenses/Other TFR+ Against Inv 240721190630 MINV00115669 RIYAD BANK HEAD OFFICE RIYADH,NONREF,Transfer,30/12/2024,"44,028.90",,14:19,30/12/2024,"15,560,133.47"
010141230H003840,YANAL FINANCE COMPANY تسديد فواتير TFR+ SAUDI INVESTMENT BANK RIYADH EX Rate : SAR 1.0000000 0101 000122 001 TRF FROM:SAUDI ARABIA 3612 PR FAWAZ BIN ABDULAZIZ,NONREF,Transfer,30/12/2024,"144,637.80",,13:43,30/12/2024,"15,516,104.57"
280872501EV1,ACE GALLAGHER ARABIA CO TFR+,SALAM INVS,Transfer,30/12/2024,"360,087.87",,13:20,30/12/2024,"15,371,466.77"
NCBK82424365AQUS,شركة الرياض العالمية للاغذية الرياض العالمية للاغذية Operating Expenses TFR+ Operational Maintenance NATIONAL COMMERCIAL BANK NATIONAL COMMERCIAL BANK EX Rate : SAR 1.0000000,NONREF,Transfer,30/12/2024,"1,207.50",,13:07,30/12/2024,"15,011,378.90"
LP CPM4057MZ,"CHARGES SAR 7.00 5388724022KA CORP OPS DIV RIYADH TOTAL VAT SAR1,05 ON CHARGE AMOUNT SAR7,",609720,Charges,30/12/2024,,-8.05,12:45,30/12/2024,"15,010,171.40"
LP CPM4057MZ,TECHNICAL LINKS SERVICES COMPANY 5388724022KA BANQUE SAUDI FRANSI CORP OPS DIV RIYADH EX Rate : SAR 1.0000000 BANQUE SAUDI FRANSI TRF TO:SAUDI ARABIA,609720,Transfer,30/12/2024,,"-15,000,000.00",12:45,30/12/2024,"15,010,179.45"
36997250155W,ERNST AND YOUNG COMPANY 154-006662-001 /RFB/ITC INVOICE PAYMENT /INV/SA01700002721,609575,Transfer,30/12/2024,,"-351,900.00",12:44,30/12/2024,"30,010,179.45"
5.00003E+11,AHMED G ALGHAMDI AND BROS CO AHMED G ALGHAMDI AND BRO INTB0054097201700028482E TFR+ AL RAJHI BANKING AND INV T CORP HEAD OFFICE RIYADH EX Rate : SAR 1.0000000,NONREF,Transfer,30/12/2024,"23,805.00",,12:39,30/12/2024,"30,362,079.45"
YRTI-22749,LP IPSP2400MHUY9 Al Zahraa General Hospit SA3730400107030209850016 Arab National Bank RIYADH 20241230SAARNBARNB1B66611229215206 30DEC24 12:30:18,NONREF,Transfer,30/12/2024,"14,870.20",,12:30,30/12/2024,"30,338,274.45"
6958721014PF,SAUDI ELECTRONIC GAMING TFR+,NONREF,Transfer,30/12/2024,"240,175.20",,12:14,30/12/2024,"30,323,404.25"
9466836509512U4M,شركة الفاضلي للتشغيل والصيانة شركة TFR+ invoices payment 424000953 RIYAD BANK HEAD OFFICE RIYADH EX Rate : SAR 1.0000000 SA1120000003233221899940,NONREF,Transfer,30/12/2024,"86,016.27",,12:09,30/12/2024,"30,083,229.05"
YRTI-21077,LP IPSP2400MHOLQ ROSH RAYHAAN BY ROTANA SA3930400108095224760015 Arab National Bank RIYADH 20241230SAARNBARNB1B31111158196448 30DEC24 11:58:57,NONREF,Transfer,30/12/2024,"14,406.76",,11:58,30/12/2024,"29,997,212.78"
YRTI-20969,LP IPSP2400MHODC AFRAS CO FOR TRADING AND SA9320000002970013229948 Riyad Bank RIYADH 20241230SARIBLRIBL6BTMS11156647078 30DEC24 11:56:49,NONREF,Transfer,30/12/2024,"6,440.00",,11:56,30/12/2024,"29,982,806.02"
EPHR98124365E0H4,SICO CAPITAL INV240711224686 TFR+ BANQUE SAUDI FRANSI HEAD OFFICE RIYADH EX Rate : SAR 1.0000000 SA5655000000078131500151 TRF FROM:SAUDI ARABIA 0000 11546,NONREF,Transfer,30/12/2024,"36,225.00",,11:43,30/12/2024,"29,976,366.02"
EPHR98124365E0H2,SICO CAPITAL MINV00132508 TFR+ BANQUE SAUDI FRANSI HEAD OFFICE RIYADH EX Rate : SAR 1.0000000 SA5655000000078131500151 TRF FROM:SAUDI ARABIA 0000 11546,NONREF,Transfer,30/12/2024,"34,943.54",,11:43,30/12/2024,"29,940,141.02"
EPHR98124365E0GY,SICO CAPITAL MINV00132507 TFR+ BANQUE SAUDI FRANSI HEAD OFFICE RIYADH EX Rate : SAR 1.0000000 SA5655000000078131500151 TRF FROM:SAUDI ARABIA 0000 11546,NONREF,Transfer,30/12/2024,"34,943.54",,11:43,30/12/2024,"29,905,197.48"
EPHR98124365E0GV,SICO CAPITAL MINV00133920 TFR+ BANQUE SAUDI FRANSI HEAD OFFICE RIYADH EX Rate : SAR 1.0000000 SA5655000000078131500151 TRF FROM:SAUDI ARABIA 0000 11546,NONREF,Transfer,30/12/2024,"36,225.00",,11:43,30/12/2024,"29,870,253.94"
LP IPSP2400MHKLJ,"20241230SASABBSABB6BNET11132161974 TOT CHG SAR 1.00 RIYAD BANK HEAD OFFICE RIYADH VATABLE SAR 1.00 VAT AMT SAR 0.15 STANDARD RATE AT 000000000000015 TOTAL VAT SAR0,15 ON CHARGE AMOUNT SAR1,",FIN SETT 4362241,Charges,30/12/2024,,-1.15,11:32,30/12/2024,"29,834,028.94"
LP IPSP2400MHKLJ,NADIA MOHAMMED OMAR ABDULMOHSEN 20241230SASABBSABB6BNET11132161974 SA8620000003472740559940RIYAD BANK HEAD OFFICE RIYADHEX Rate SAR 1.0000000,FIN SETT 4362241,Transfer,30/12/2024,,"-17,851.00",11:32,30/12/2024,"29,834,030.09"
LP CPMN2ZNISIRN,"CHARGES SAR 7.00 45067250114K THE NATIONAL COMMERCIAL BANK TOTAL VAT SAR1,05 ON CHARGE AMOUNT SAR7,",609725,Charges,30/12/2024,,-8.05,11:32,30/12/2024,"29,851,881.09"
LP CPMN2ZNISIRN,DAWIYAT INTEGRATED TELECOM 45067250114K INTEGRATED TELECOM CO. NATIONAL COMMERCIAL BANK THE NATIONAL COMMERCIAL BANK EX Rate : SAR 1.0000000 NATIONAL COMMERCIAL BANK,609725,Transfer,30/12/2024,,"-4,000,000.00",11:32,30/12/2024,"29,851,889.14"
LP CPMN2ZNIOIRN,"CHARGES SAR 7.00 679172401B4R THE NATIONAL COMMERCIAL BANK TOTAL VAT SAR1,05 ON CHARGE AMOUNT SAR7,",MANUAL 4362350,Charges,30/12/2024,,-8.05,11:32,30/12/2024,"33,851,889.14"
LP CPMN2ZNIOIRN,SHAIK ALAUDEEN JAHABAR MARKAR 679172401B4R NATIONAL COMMERCIAL BANK THE NATIONAL COMMERCIAL BANK EX Rate : SAR 1.0000000 NATIONAL COMMERCIAL BANK TRF TO:SAUDI ARABIA,MANUAL 4362350,Transfer,30/12/2024,,"-6,409.00",11:32,30/12/2024,"33,851,897.19"
LP CPMN2ZNINIRN,"CHARGES SAR 7.00 356672401EFP DOLLAR CLEARING A/C JEDD AH TOTAL VAT SAR1,05 ON CHARGE AMOUNT SAR7,",FIN SETT 4362246,Charges,30/12/2024,,-8.05,11:32,30/12/2024,"33,858,306.19"
LP CPMN2ZNINIRN,ABDULLAH MUBARAK MASOUD ALASMARI 356672401EFP BANK AL-JAZIRA DOLLAR CLEARING A/C JEDD AH EX Rate : SAR 1.0000000 BANK AL-JAZIRA TRF TO:SAUDI ARABIA,FIN SETT 4362246,Transfer,30/12/2024,,"-28,803.00",11:32,30/12/2024,"33,858,314.24"
0460724001XJ,ARAR GHASSAN 815-009675-001,609717,Transfer,30/12/2024,,"-35,000.00",11:32,30/12/2024,"33,887,117.24"
SDR5-00029,SEVING THOMAS THDMDIYIL SADAD SNB17676 ID : I 2531931729 RYADH 0533397327 SNB,NONREF,Cheque,1/1/2025,"31,050.00",,11:27,30/12/2024,"33,922,117.24"
047272501JQ2,FOUR WINDS SAUDI ARABIA TFR+,VPYMT-JED1601,Transfer,30/12/2024,"11,033.10",,11:24,30/12/2024,"33,891,067.24"
SA2OL2412300000U,LANDMARK ARABIA COMPANY TFR+ /Narr/BRT 1201000714 Misc Payment STANDARD CHARTERED CAPIT AL (SAUDI A STANDARD CHARTERED CAPIT AL SAUDI EX Rate : SAR 1.0000000,NONREF,Transfer,30/12/2024,"6,641.25",,11:16,30/12/2024,"33,880,034.14"
5.00003E+11,KUN SPORTS COMPANY TFR+ AL RAJHI BANKING AND INV T CORP HEAD OFFICE RIYADH EX Rate : SAR 1.0000000 SA1780000577608010071002 TRF FROM:SAUDI ARABIA,NONREF,Transfer,30/12/2024,"99,000.00",,11:12,30/12/2024,"33,873,392.89"
V241230101050624,401014602225901 :تنفيذ قضااى 401014602225901 :ذ قضااى /99/17031623 TFR+ AL RAJHI BANKING AND INV T CORP HEAD OFFICE RIYADH EX Rate : SAR 1.0000000,NONREF,Transfer,30/12/2024,"1,500.00",,11:12,30/12/2024,"33,774,392.89"
010141230H003788,MOHAMMED SAAD ALBAWARDY AND SONS CO TFR+ MINV00139792 SAUDI INVESTMENT BANK RIYADH EX Rate : SAR 1.0000000 0138 588802 004 TRF FROM:SAUDI ARABIA,NONREF,Transfer,30/12/2024,"112,677.00",,11:11,30/12/2024,"33,772,892.89"
NCBK82424365ALOM,RIYADH SCHOOLS (CUR) مصاريف تشغيل TFR+ فواتير خدمات NATIONAL COMMERCIAL BANK NATIONAL COMMERCIAL BANK EX Rate : SAR 1.0000000 53600003282208 TRF FROM:SAUDI ARABIA,NONREF,Transfer,30/12/2024,"575,409.30",,11:06,30/12/2024,"33,660,215.89"
NCBK82424364AQTI,AL RUSHAID TECH CO TFR+ Full payment of Finished Goods NATIONAL COMMERCIAL BANK NATIONAL COMMERCIAL BANK EX Rate : SAR 1.0000000 95400004899008 TRF FROM:SAUDI ARABIA,NONREF,Transfer,30/12/2024,"178,530.22",,10:58,30/12/2024,"33,084,806.59"
YRTI-16367,LP IPSP2400MHC4E SICO CAPITAL SA5655000000078131500151 Banque Saudi Fransi RIYADH 20241230SABSFRBSFR6BCFT11033138187 30DEC24 10:33:25,NONREF,Transfer,30/12/2024,"3,570.75",,10:33,30/12/2024,"32,906,276.37"
YRTI-16353,LP IPSP2400MHBJA SICO CAPITAL SA5655000000078131500151 Banque Saudi Fransi RIYADH 20241230SABSFRBSFR6BCFT11033138174 30DEC24 10:33:13,NONREF,Transfer,30/12/2024,"3,570.75",,10:33,30/12/2024,"32,902,705.62"
YRTI-16346,LP IPSP2400MHC4A SICO CAPITAL SA5655000000078131500151 Banque Saudi Fransi RIYADH 20241230SABSFRBSFR6BCFT11032138170 30DEC24 10:33:07,NONREF,Transfer,30/12/2024,"3,570.75",,10:33,30/12/2024,"32,899,134.87"
YRTI-16327,LP IPSP2400MHBJ0 SICO CAPITAL SA5655000000078131500151 Banque Saudi Fransi RIYADH 20241230SABSFRBSFR6BCFT11032138163 30DEC24 10:32:55,NONREF,Transfer,30/12/2024,"11,730.00",,10:32,30/12/2024,"32,895,564.12"
YRTI-16320,LP IPSP2400MHBTE SICO CAPITAL SA5655000000078131500151 Banque Saudi Fransi RIYADH 20241230SABSFRBSFR6BCFT11032138158 30DEC24 10:32:49,NONREF,Transfer,30/12/2024,"3,570.75",,10:32,30/12/2024,"32,883,834.12"
YRTI-16309,LP IPSP2400MHBTD SICO CAPITAL SA5655000000078131500151 Banque Saudi Fransi RIYADH 20241230SABSFRBSFR6BCFT11032138152 30DEC24 10:32:43,NONREF,Transfer,30/12/2024,"14,791.38",,10:32,30/12/2024,"32,880,263.37"
YRTI-16306,LP IPSP2400MHBIT SICO CAPITAL SA5655000000078131500151 Banque Saudi Fransi RIYADH 20241230SABSFRBSFR6BCFT11032138149 30DEC24 10:32:40,NONREF,Transfer,30/12/2024,"11,730.00",,10:32,30/12/2024,"32,865,471.99"
ECOF41229H000915,DIGITAL SOLUTIONS PROVIDER CO.LTD DIGITAL SOLUTIONS PROVID Operational Expenses TFR+ BANK AL-JAZIRA HEAD OFFICE JEDDAH EX Rate : SAR 1.0000000 SA2560000000006788788001,NONREF,Transfer,30/12/2024,"200,000.00",,10:31,30/12/2024,"32,853,741.99"
4364374DC0047448,IBHAR ALBENA REAL ESTATE CO IBHAR ALBENA REAL ESTATE مصاريف أو خدمات TFR+ ARAB NATIONAL BANK RIYADH BRANCH EX Rate : SAR 1.0000000 0108056128370014,NONREF,Transfer,30/12/2024,"389,250.00",,10:20,30/12/2024,"32,653,741.99"
EPHR98124365D356,TADHAMON AL HIMMA CO. LTD. RADISSON TFR+ BANQUE SAUDI FRANSI HEAD OFFICE RIYADH EX Rate : SAR 1.0000000 SA5655000000099399200134 TRF FROM:SAUDI ARABIA 7403 34334,NONREF,Transfer,30/12/2024,"265,276.56",,10:18,30/12/2024,"32,264,491.99"
EPHR98124365D39W,ALJUBAIL INDUSTRIAL CITY HOTEL CO. ALJUBAIL INDUSTRIAL CITY INVOICE PAYMENT TFR+ BANQUE SAUDI FRANSI HEAD OFFICE RIYADH EX Rate : SAR 1.0000000 SA5655000000096866300147,NONREF,Transfer,30/12/2024,"70,035.00",,10:18,30/12/2024,"31,999,215.43"
NCBK82424364AJRD,ؤسسة مكامن التوريد للاتصالات و تقن التوريد للاتصالات و تقن مصاريف تشغيل TFR+ فواتير خدمات NATIONAL COMMERCIAL BANK NATIONAL COMMERCIAL BANK EX Rate : SAR 1.0000000,NONREF,Transfer,30/12/2024,"45,505.00",,10:02,30/12/2024,"31,929,180.43"
609472101OTY,GULF INDUSTRIAL GROUP TFR+,NONREF,Transfer,30/12/2024,"22,321.50",,22:23,30/12/2024,"31,883,675.43"
ZAFD-00329,"STANDING INSTRUCTION 001 MONTHLY HSBCNET CHARGES 29DEC24 20:10:22 TOTAL VAT SAR45, ON CHARGE AMOUNT SAR300,",NONREF,Charges,29/12/2024,,-45,20:10,29/12/2024,"31,861,353.93"
ZAFD-00329,STANDING INSTRUCTION 001 MONTHLY HSBCNET CHARGES RIYADH 29DEC24 20:10:22,NONREF,Transfer,29/12/2024,,-300,20:10,29/12/2024,"31,861,398.93"
ZAFA-00034,TRANSFER FROM LOUIS BERGER LOUIS BERGER SUPPLIER PAYMENT INV,NONREF,Transfer,29/12/2024,"9,131.89",,20:08,29/12/2024,"31,861,698.93"
YRTJ-31560,LP IPSP2400MFRD8 تصاﻻت التقنية التجارية SA3910000008667817000108 Saudi National Bank JEDDAH 20241229SANCBKNCBK6B82411853060863 29DEC24 18:53:58,NONREF,Transfer,29/12/2024,"9,803.18",,18:53,29/12/2024,"31,852,567.04"
514372401OJE,GEIDEA FOR TECHNOLOGY CO TFR+,1800001462,Transfer,29/12/2024,"639,914.31",,17:08,29/12/2024,"31,842,763.86"
YRTJ-23895,LP IPSP2400MFB0Y CONSUMER FOOD CO SA7780000514608010020013 Alrajhi Bank RIYADH 20241229SARJHIRJHI6BOPF11633726550 29DEC24 16:33:44,NONREF,Transfer,29/12/2024,"7,210.50",,16:33,29/12/2024,"31,202,849.55"
BTPT-00310,20241229154111 7001472674BLR:094SVR:026 SADAD:5690680785,list 111,Transfer,29/12/2024,,-300,15:41,29/12/2024,"31,195,639.05"
BTPS-00308,20241229154110 7001472674BLR:094SVR:026 SADAD:5690678765,list 111,Transfer,29/12/2024,,-300,15:41,29/12/2024,"31,195,939.05"
BTPR-00307,20241229154109 2554393047BLR:090SVR:003 SADAD:5690680745,LIST 111,Transfer,29/12/2024,,-650,15:41,29/12/2024,"31,196,239.05"
BTPN-00305,20241229154104 7021690339BLR:095SVR:039 SADAD:5690678667,110,Transfer,29/12/2024,,"-2,000.00",15:41,29/12/2024,"31,196,889.05"
BTPH-00310,20241229154053 2287243105BLR:090SVR:003 SADAD:5690680475,list 108,Transfer,29/12/2024,,-650,15:40,29/12/2024,"31,198,889.05"
NCBK82424364AVBO,شركة الرياض العالمية للاغذية الرياض العالمية للاغذية Operating Expenses TFR+ Operational Maintenance NATIONAL COMMERCIAL BANK NATIONAL COMMERCIAL BANK EX Rate : SAR 1.0000000,NONREF,Transfer,29/12/2024,"16,560.00",,15:33,29/12/2024,"31,199,539.05"
P133834941EBPLUS,RAYADAH INTERNET SERVICE PROVIDER RAYADAH INTERNET SERVICE COMPANIES FOR OTHER PURP TFR+ ARAB NATIONAL BANK RIYADH BRANCH EX Rate : SAR 1.0000000 0108095317070014,NONREF,Transfer,29/12/2024,"900,000.00",,15:33,29/12/2024,"31,182,979.05"
5.00003E+11,MIDDLE EAST AND NORTH AFRICA BEVERA TFR+ AL RAJHI BANKING AND INV T CORP HEAD OFFICE RIYADH EX Rate : SAR 1.0000000 SA5980000425608013002008 TRF FROM:SAUDI ARABIA,NONREF,Transfer,29/12/2024,"122,800.45",,14:54,29/12/2024,"30,282,979.05"
714872401JYQ,ALMOUWASAT DAMMAM TFR+,V.PYM-DEC.24,Transfer,29/12/2024,"16,905.00",,13:59,29/12/2024,"30,160,178.60"
NCBK82424364ARLS,ركه الشرق الأوسط للانترنت المحدودة TFR+ فواتير خدمات NATIONAL COMMERCIAL BANK NATIONAL COMMERCIAL BANK EX Rate : SAR 1.0000000 25056888000109 TRF FROM:SAUDI ARABIA,NONREF,Transfer,29/12/2024,"1,400,563.00",,13:54,29/12/2024,"30,143,273.60"
1.95702E+13,HUMAN RESOUACES DEVELOPMENT FUND TFR+ ARAB NATIONAL BANK RIYADH BRANCH EX Rate : SAR 1.0000000 UMAN RESOUACES DEVELOPMENT FUND TRF FROM:SAUDI ARABIA 67778 11517,NONREF,Transfer,29/12/2024,"64,130.00",,13:26,29/12/2024,"28,742,710.60"
YRTJ-12590,LP IPSP2400MEL1L MOBILE BUSINESS COMPANY SA6620000002580926839940 Riyad Bank RIYADH 20241229SARIBLRIBL6BTMS11318186478 29DEC24 13:18:42,NONREF,Transfer,29/12/2024,"12,500.00",,13:18,29/12/2024,"28,678,580.60"
1604FT24364ZH4WC,HOTELS CROWNE PLAZA ALSALAM HOTELS CROWNE PLAZA ALSA 23173545701141400 CROWNE TFR+ SALAM SETTLEMENT OF BILL ALINMA BANK ALINMA BANK,NONREF,Transfer,29/12/2024,"69,000.00",,13:18,29/12/2024,"28,666,080.60"
NCBK98124364049L,شركة مجموعة الخريف مساهمة مقفله موعة الخريف مساهمة مقفله /TRF/INVOICE PAY TFR+ NATIONAL COMMERCIAL BANK NATIONAL COMMERCIAL BANK EX Rate : SAR 1.0000000 SA3910000065900000318206,NONREF,Transfer,29/12/2024,"597,269.15",,12:48,29/12/2024,"28,597,080.60"
ECOF41229H000480,ALBALAD DEVELOPMENT COMPANY ALBALAD DEVELOPMENT COMP Operational Expenses TFR+ BANK AL-JAZIRA HEAD OFFICE JEDDAH EX Rate : SAR 1.0000000 SA0860100030995010711002,NONREF,Transfer,29/12/2024,"317,400.00",,12:43,29/12/2024,"27,999,811.45"
5.00003E+11,muasasat ainjaz alwatan alaminia TFR+ AL RAJHI BANKING AND INV T CORP HEAD OFFICE RIYADH EX Rate : SAR 1.0000000 SA3880000614608016081513 TRF FROM:SAUDI ARABIA,NONREF,Transfer,29/12/2024,"46,834.90",,12:12,29/12/2024,"27,682,411.45"
YRTJ-08296,LP IPSP2400MEA2P المحدودة شركة شخص واحد ـ SA5310000019149351000109 Saudi National Bank JEDDAH 20241229SANCBKNCBK6B82411203246963 29DEC24 12:04:07,NONREF,Transfer,29/12/2024,"4,005.45",,12:04,29/12/2024,"27,635,576.55"
BTPB-00174,3000004712 044 3000004712 SADAD:5690173438,609579,Transfer,29/12/2024,,"-1,031.55",11:54,29/12/2024,"27,631,571.10"
BTPA-00175,3000004712 044 3000004712 SADAD:5690171327,609580,Transfer,29/12/2024,,"-1,031.55",11:54,29/12/2024,"27,632,602.65"
BTPZ-00173,241100015586 028 241100015586 SADAD:5690172989,609699,Transfer,29/12/2024,,-200,11:54,29/12/2024,"27,633,634.20"
BTPY-00173,16460601429913 050 16460601429913 SADAD:5690172970,LIST 111,Transfer,29/12/2024,,"-9,700.00",11:54,29/12/2024,"27,633,834.20"
BTPV-00171,241100015651 028 241100015651 SADAD:5690171213,609699,Transfer,29/12/2024,,-500,11:54,29/12/2024,"27,643,534.20"
BTPU-00171,9919061349 018 9919061349 SADAD:5690171197,Amex Dec.24,Transfer,29/12/2024,,"-39,319.73",11:54,29/12/2024,"27,644,034.20"
BTPT-00173,3000472438243011 020 3000472438243011 SADAD:5690171179,MANUAL 4124685,Transfer,29/12/2024,,"-6,299,729.96",11:54,29/12/2024,"27,683,353.93"
668471Y015SK,HADDAD KAMEL 001-087949-001 /RFB/EXEC. ADVANCE,MANUAL 4361819,Transfer,29/12/2024,,"-20,240.88",11:47,29/12/2024,"33,983,083.89"
LP CPMN2ZFF5IRN,"CHARGES SAR 7.00 7059724020T9 THE NATIONAL COMMERCIAL BANK TOTAL VAT SAR1,05 ON CHARGE AMOUNT SAR7,",609718,Charges,29/12/2024,,-8.05,11:47,29/12/2024,"34,003,324.77"
LP CPMN2ZFF5IRN,DAWIYAT INTEGRATED TELECOM 7059724020T9 INTEGRATED TELECOM CO. NATIONAL COMMERCIAL BANK THE NATIONAL COMMERCIAL BANK EX Rate : SAR 1.0000000 NATIONAL COMMERCIAL BANK,609718,Transfer,29/12/2024,,"-8,000,000.00",11:47,29/12/2024,"34,003,332.82"
LP CPMN2ZFF4IRN,"CHARGES SAR 7.00 101172401XAG CORP OPS DIV RIYADH TOTAL VAT SAR1,05 ON CHARGE AMOUNT SAR7,",609719,Charges,29/12/2024,,-8.05,11:47,29/12/2024,"42,003,332.82"
LP CPMN2ZFF4IRN,TECHNICAL LINKS SERVICES COMPANY 101172401XAG BANQUE SAUDI FRANSI CORP OPS DIV RIYADH EX Rate : SAR 1.0000000 BANQUE SAUDI FRANSI TRF TO:SAUDI ARABIA,609719,Transfer,29/12/2024,,"-10,000,000.00",11:47,29/12/2024,"42,003,340.87"
EPHR981243649C23,HIGH CAPABILITIES TELECOM CO. HIGH CAPABILITIES TELECO PAYMENT INV 240811207719 TFR+ 8719 BANQUE SAUDI FRANSI HEAD OFFICE RIYADH EX Rate : SAR 1.0000000,NONREF,Transfer,29/12/2024,"47,886.00",,11:46,29/12/2024,"52,003,340.87"
8.04577E+15,ALNAHDI MEDICAL CO TFR+,120792,Transfer,29/12/2024,"68,316.90",,11:25,29/12/2024,"51,955,454.87"
5.00003E+11,MANAGEMENT AND DEVELOPMENT FOR HR C MANAGEMENT AND DEVELOPME /03/Personal remittances TFR+ INTB0116449535040088897E4C292893 AL RAJHI BANKING AND INV T CORP HEAD OFFICE RIYADH,NONREF,Transfer,29/12/2024,"786,600.00",,11:10,29/12/2024,"51,887,137.97"
YRTJ-04685,LP IPSP2400ME379 VETCO SAUDI ARABIA LTD SA1020000003023036499940 Riyad Bank RIYADH 20241229SARIBLRIBL6BTMS11103125278 29DEC24 11:03:43,NONREF,Transfer,29/12/2024,"17,940.00",,11:03,29/12/2024,"51,100,537.97"
EPHR98124364949N,ARABIAN GEOPHYSICAL + SURVEYING CO ARABIAN GEOPHYSICAL + SU JBS1 0004199 PVS1 00 TFR+ BANQUE SAUDI FRANSI HEAD OFFICE RIYADH EX Rate : SAR 1.0000000 SA5655000000021015203260,NONREF,Transfer,29/12/2024,"27,220.35",,10:48,29/12/2024,"51,082,597.97"
5.00003E+11,EXSA LLTQNEH CO INTB0065089475810069109E TFR+ AL RAJHI BANKING AND INV T CORP HEAD OFFICE RIYADH EX Rate : SAR 1.0000000 SA4180000581608010069109 TRF FROM:SAUDI ARABIA,NONREF,Transfer,29/12/2024,"100,000.00",,10:41,29/12/2024,"51,055,377.62"
5.00003E+11,muasasat ainjaz alwatan alaminia muasasat ainjaz alwatan INTB0234551756146081513E TFR+ AL RAJHI BANKING AND INV T CORP HEAD OFFICE RIYADH EX Rate : SAR 1.0000000,NONREF,Transfer,29/12/2024,"31,223.65",,10:34,29/12/2024,"50,955,377.62"
200GTSA243630505,"SAUDI GLOBAL PORTS CO. L.L.C. SAUDI GLOBAL PORTS CO. L Others,14 INV TFR+ GULF INTERNATIONAL BANK BSC RIYADH EX Rate : SAR 1.0000000",NONREF,Transfer,29/12/2024,"713,805.00",,10:26,29/12/2024,"50,924,153.97"
9466836109512GF3,السواعد الكريمة للاستثمار وللتطوير كريمة للاستثمار وللتطوير Purchase/expenses/Hotel TFR+ July to sep 23 RIYAD BANK HEAD OFFICE RIYADH EX Rate : SAR 1.0000000,NONREF,Transfer,29/12/2024,"159,390.00",,10:22,29/12/2024,"50,210,348.97"
ECOF41226H001339,MILLENNIUM COPTHORNE ALNASEEM HOTEL MILLENNIUM COPTHORNE ALN Operational Expenses TFR+ BANK AL-JAZIRA HEAD OFFICE JEDDAH EX Rate : SAR 1.0000000 SA5760100030995010119002,NONREF,Transfer,29/12/2024,"84,697.50",,10:22,29/12/2024,"50,050,958.97"
ECOF41228H000192,ALRABIH BILAHODOD SERVICES HOTEL CO ALRABIH BILAHODOD SERVIC مصاريف تشغيلية TFR+ BANK AL-JAZIRA HEAD OFFICE JEDDAH EX Rate : SAR 1.0000000 SA8560100002281433946001,NONREF,Transfer,29/12/2024,"22,425.00",,10:21,29/12/2024,"49,966,261.47"
9466836109512F9G,شركة مينا الحديثة للتعليم ركة مينا الحديثة للتعليم Purchase/expenses/Utilit TFR+ PAYMENT RIYAD BANK HEAD OFFICE RIYADH EX Rate : SAR 1.0000000,NONREF,Transfer,29/12/2024,"33,911.30",,10:19,29/12/2024,"49,943,836.47"
YRTJ-02059,LP IPSP2400MDY7Q FOOD WORLD CO SA0780000578608010018655 Alrajhi Bank RIYADH 20241229SARJHIRJHI6BOPF11018998957 29DEC24 10:18:33,NONREF,Transfer,29/12/2024,"3,456.90",,10:18,29/12/2024,"49,909,925.17"
NCBK82824361BGCC,رياض ملهي العريفي Operating Expenses TFR+ /PHONBEN/ /TELEBEN/ NATIONAL COMMERCIAL BANK NATIONAL COMMERCIAL BANK EX Rate : SAR 1.0000000 13550848000109,NONREF,Transfer,29/12/2024,"20,274.00",,10:08,29/12/2024,"49,906,468.27"
1604FT243631RZGJ,INTERCONTINENTAL JEDDAH HOTEL INTERCONTINENTAL JEDDAH 23173511761084100 SALAM TFR+ R 24 OCT TO DEC 24 SETTLEMENT OF BILL ALINMA BANK ALINMA BANK,NONREF,Transfer,29/12/2024,"221,462.40",,10:05,29/12/2024,"49,886,194.27"
010141225H795595,SAUDI FUND FOR DEVELOPMENT SAUDI FUND FOR DEVELOPME 24015115125CINV BA TFR+ SAUDI INVESTMENT BANK RIYADH EX Rate : SAR 1.0000000 0101 400960 015,NONREF,Transfer,29/12/2024,"22,425.00",,9:18,29/12/2024,"49,664,731.87"
YRTI-97856,LP IPSP2400MDQ5I AFLUN SA8780000343608019035415 Alrajhi Bank RIYADH 20241229SARJHIRJHI6BOPF10849859398 29DEC24 08:49:47,NONREF,Transfer,29/12/2024,"4,880.17",,8:49,29/12/2024,"49,642,306.87"
YRTI-97469,LP IPSP2400MDP5T اﻻت و تق نية المعلومات SA7910000012347102005802 Saudi National Bank JEDDAH 20241229SANCBKNCBK6B82410834930065 29DEC24 08:35:04,NONREF,Transfer,29/12/2024,"1,738.80",,8:35,29/12/2024,"49,637,426.70"
YRTI-97388,LP IPSP2400MDPAP اﻻت و تق نية المعلومات SA7910000012347102005802 Saudi National Bank JEDDAH 20241229SANCBKNCBK6B82410832927456 29DEC24 08:32:24,NONREF,Transfer,29/12/2024,"3,726.00",,8:32,29/12/2024,"49,635,687.90"
YRTI-97342,LP IPSP2400MDPFP اﻻت و تق نية المعلومات SA7910000012347102005802 Saudi National Bank JEDDAH 20241229SANCBKNCBK6B82410830925572 29DEC24 08:30:17,NONREF,Transfer,29/12/2024,"7,079.00",,8:30,29/12/2024,"49,631,961.90"
LP CPMN2ZBKLIRN,"CHARGES SAR 7.00 313872100JDI RIYADH TOTAL VAT SAR1,05 ON CHARGE AMOUNT SAR7,",609711,Charges,29/12/2024,,-8.05,1:31,29/12/2024,"49,624,882.90"
LP CPMN2ZBKLIRN,MIDDLE EAST AND AFRICA GROUP TECH. 313872100JDI /RFB/ITC INVOICE PAYMENT SAUDI INVESTMENT BANK RIYADH EX Rate : SAR 1.0000000 SAUDI INVESTMENT BANK TRF TO:SAUDI ARABIA,609711,Transfer,29/12/2024,,"-4,658,796.03",1:31,29/12/2024,"49,624,890.95"
1020723001NN,SSEM TFR+,NONREF,Transfer,29/12/2024,"206,885.00",,12:32,29/12/2024,"54,283,686.98"
YRTI-30179,LP IPSP2400M9UZR ZARQA COMPANY FOR HUMAN SA2180000473608010188553 Alrajhi Bank RIYADH 20241227SARJHIRJHI6BOPF11704422811 27DEC24 17:04:19,NONREF,Transfer,29/12/2024,"17,000.00",,17:04,29/12/2024,"54,076,801.98"
EBE4-08867,FROM LABOTIC COMPANY FOR Salam INVESTMENT PURPOSE,NONREF,Transfer,29/12/2024,"270,262.32",,0:21,29/12/2024,"54,059,801.98"
SAUDI ARABIAN OI,2000294559 /INV//CINV241031273206 TFR+,2000294559,Transfer,29/12/2024,"223,541.60",,23:03,29/12/2024,"53,789,539.66"
372072100H8H,INTERACTIVE SMART COMPAN 011-810124-001,609713,Transfer,26/12/2024,,"-676,293.63",19:48,26/12/2024,"53,565,998.06"
325272101Q56,INTERACTIVE SMART COMPAN 011-810124-001,609715,Transfer,26/12/2024,,"-1,359,805.74",19:48,26/12/2024,"54,242,291.69"
222372101OL8,INTERACTIVE SMART COMPAN 011-810124-001,609581,Transfer,26/12/2024,,"-1,535,230.83",19:48,26/12/2024,"55,602,097.43"
489671Z01NKS,UNITED CARTON INDUSTRIES TFR+,PAYMENT INVOICE,Transfer,26/12/2024,"30,532.50",,17:40,26/12/2024,"57,137,328.26"
172072101NRF,MADA GYPSUM COMPANY TFR+,DUE PMT,Transfer,26/12/2024,"73,705.80",,15:55,26/12/2024,"57,106,795.76"
LP CPMN2ZAORIRN,"CHARGES SAR 7.00 316372000GNF ALINMA BANK TOTAL VAT SAR1,05 ON CHARGE AMOUNT SAR7,",609708,Charges,26/12/2024,,-8.05,15:18,26/12/2024,"57,033,089.96"
LP CPMN2ZAORIRN,BELAL AMIN AHMAD ALHDHYFY LTAJYR LW 316372000GNF ALINMA BANK ALINMA BANK EX Rate : SAR 1.0000000 ALINMA BANK TRF TO:SAUDI ARABIA,609708,Transfer,26/12/2024,,"-5,750.00",15:18,26/12/2024,"57,033,098.01"
TT CPMN0JT25IRNN,"CHARGES SAR 130.00 4540720008VU TOTAL VAT SAR19,5 ON CHARGE AMOUNT SAR130,",609304,Charges,26/12/2024,,-149.5,15:18,26/12/2024,"57,038,848.01"
TT CPMN0JT25IRNN,KALAAM TELECOM BAHRAIN B.S.C (C) 4540720008VU EX Rate : SAR 3.7550000 AHLI UNITED BANK BSC TRF TO:BAHRAIN,609304,Transfer,26/12/2024,,-525.7,15:18,26/12/2024,"57,038,997.51"
LP CPMN2ZAOQIRN,"CHARGES SAR 7.00 5528720007ET RIYADH TOTAL VAT SAR1,05 ON CHARGE AMOUNT SAR7,",609701,Charges,26/12/2024,,-8.05,15:18,26/12/2024,"57,039,523.21"
LP CPMN2ZAOQIRN,MOARD STEPHEN FOR BUSINESS SOLUTION 5528720007ET SAUDI INVESTMENT BANK RIYADH EX Rate : SAR 1.0000000 SAUDI INVESTMENT BANK TRF TO:SAUDI ARABIA,609701,Transfer,26/12/2024,,"-587,451.11",15:18,26/12/2024,"57,039,531.26"
401871Z00H6Y,IJARAH LIMITED CO TFR+ /RFB/INTERNET FEE,INV241111268669,Transfer,26/12/2024,"34,482.75",,15:17,26/12/2024,"57,626,982.37"
5.00003E+11,KUN SPORTS COMPANY /33/Repayment of Loans TFR+ INTB0242066955770071002E4C264315 AL RAJHI BANKING AND INV T CORP HEAD OFFICE RIYADH EX Rate : SAR 1.0000000 SA1780000577608010071002,NONREF,Transfer,26/12/2024,"33,083.78",,15:12,26/12/2024,"57,592,499.62"
357672101XPK,MOHAMED YOUSUF NAGHI MOT TFR+ INV241021275654 INV241121285227 INV241121286768 CN241121286767,SALAM,Transfer,26/12/2024,"31,957.38",,15:10,26/12/2024,"57,559,415.84"
25215219,وزارة المالية TRANSFER TO VENDORN TFR+ Saudi Arabian Monetary A uthority HEAD OFFICE RIYADH EX Rate : SAR 1.0000000 TRF FROM:SAUDI ARABIA,NONREF,Transfer,26/12/2024,"37,381.50",,15:03,26/12/2024,"57,527,458.46"
25215218,وزارة المالية TRANSFER TO VENDORN TFR+ Saudi Arabian Monetary A uthority HEAD OFFICE RIYADH EX Rate : SAR 1.0000000 TRF FROM:SAUDI ARABIA,NONREF,Transfer,26/12/2024,"249,210.00",,15:03,26/12/2024,"57,490,076.96"
25205648,وزارة المالية TRANSFER TO VENDORN TFR+ Saudi Arabian Monetary A uthority HEAD OFFICE RIYADH EX Rate : SAR 1.0000000 TRF FROM:SAUDI ARABIA,NONREF,Transfer,26/12/2024,"5,092.32",,15:03,26/12/2024,"57,240,866.96"
25205647,وزارة المالية TRANSFER TO VENDORN TFR+ Saudi Arabian Monetary A uthority HEAD OFFICE RIYADH EX Rate : SAR 1.0000000 TRF FROM:SAUDI ARABIA,NONREF,Transfer,26/12/2024,"33,948.80",,15:03,26/12/2024,"57,235,774.64"
25261532,وزارة المالية TRANSFER TO VENDORN TFR+ Saudi Arabian Monetary A uthority HEAD OFFICE RIYADH EX Rate : SAR 1.0000000 TRF FROM:SAUDI ARABIA,NONREF,Transfer,26/12/2024,"9,240.00",,15:03,26/12/2024,"57,201,825.84"
22593705,وزارة المالية TRANSFER TO VENDORN TFR+ Saudi Arabian Monetary A uthority HEAD OFFICE RIYADH EX Rate : SAR 1.0000000 TRF FROM:SAUDI ARABIA,NONREF,Transfer,26/12/2024,"196,504.35",,15:03,26/12/2024,"57,192,585.84"
20782882,وزارة المالية TRANSFER TO VENDORN TFR+ Saudi Arabian Monetary A uthority HEAD OFFICE RIYADH EX Rate : SAR 1.0000000 TRF FROM:SAUDI ARABIA,NONREF,Transfer,26/12/2024,"38,523.36",,14:57,26/12/2024,"56,996,081.49"
22593706,وزارة المالية TRANSFER TO VENDORN TFR+ Saudi Arabian Monetary A uthority HEAD OFFICE RIYADH EX Rate : SAR 1.0000000 TRF FROM:SAUDI ARABIA,NONREF,Transfer,26/12/2024,"29,475.65",,14:57,26/12/2024,"56,957,558.13"
20782781,وزارة المالية TRANSFER TO VENDORN TFR+ Saudi Arabian Monetary A uthority HEAD OFFICE RIYADH EX Rate : SAR 1.0000000 TRF FROM:SAUDI ARABIA,NONREF,Transfer,26/12/2024,"256,822.40",,14:56,26/12/2024,"56,928,082.48"
25261531,وزارة المالية TRANSFER TO VENDORN TFR+ Saudi Arabian Monetary A uthority HEAD OFFICE RIYADH EX Rate : SAR 1.0000000 TRF FROM:SAUDI ARABIA,NONREF,Transfer,26/12/2024,"61,600.00",,14:56,26/12/2024,"56,671,260.08"
25058924,وزارة المالية TRANSFER TO VENDORN TFR+ Saudi Arabian Monetary A uthority HEAD OFFICE RIYADH EX Rate : SAR 1.0000000 TRF FROM:SAUDI ARABIA,NONREF,Transfer,26/12/2024,"34,572.00",,14:42,26/12/2024,"56,609,660.08"
25058922,وزارة المالية TRANSFER TO VENDORN TFR+ Saudi Arabian Monetary A uthority HEAD OFFICE RIYADH EX Rate : SAR 1.0000000 TRF FROM:SAUDI ARABIA,NONREF,Transfer,26/12/2024,"230,480.00",,14:42,26/12/2024,"56,575,088.08"
23898708,وزارة المالية TRANSFER TO VENDORN TFR+ Saudi Arabian Monetary A uthority HEAD OFFICE RIYADH EX Rate : SAR 1.0000000 TRF FROM:SAUDI ARABIA,NONREF,Transfer,26/12/2024,"82,364.77",,14:35,26/12/2024,"56,344,608.08"
25326174,وزارة المالية TRANSFER TO VENDORN TFR+ Saudi Arabian Monetary A uthority HEAD OFFICE RIYADH EX Rate : SAR 1.0000000 TRF FROM:SAUDI ARABIA,NONREF,Transfer,26/12/2024,"18,519.30",,14:35,26/12/2024,"56,262,243.31"
25326172,وزارة المالية TRANSFER TO VENDORN TFR+ Saudi Arabian Monetary A uthority HEAD OFFICE RIYADH EX Rate : SAR 1.0000000 TRF FROM:SAUDI ARABIA,NONREF,Transfer,26/12/2024,"34,439.40",,14:35,26/12/2024,"56,243,724.01"
25034482,وزارة المالية TRANSFER TO VENDORN TFR+ Saudi Arabian Monetary A uthority HEAD OFFICE RIYADH EX Rate : SAR 1.0000000 TRF FROM:SAUDI ARABIA,NONREF,Transfer,26/12/2024,"14,135.31",,14:35,26/12/2024,"56,209,284.61"
23898707,وزارة المالية TRANSFER TO VENDORN TFR+ Saudi Arabian Monetary A uthority HEAD OFFICE RIYADH EX Rate : SAR 1.0000000 TRF FROM:SAUDI ARABIA,NONREF,Transfer,26/12/2024,"549,098.47",,14:28,26/12/2024,"56,195,149.30"
25326173,وزارة المالية TRANSFER TO VENDORN TFR+ Saudi Arabian Monetary A uthority HEAD OFFICE RIYADH EX Rate : SAR 1.0000000 TRF FROM:SAUDI ARABIA,NONREF,Transfer,26/12/2024,"123,462.00",,14:28,26/12/2024,"55,646,050.83"
25326171,وزارة المالية TRANSFER TO VENDORN TFR+ Saudi Arabian Monetary A uthority HEAD OFFICE RIYADH EX Rate : SAR 1.0000000 TRF FROM:SAUDI ARABIA,NONREF,Transfer,26/12/2024,"229,596.00",,14:28,26/12/2024,"55,522,588.83"
25034481,وزارة المالية TRANSFER TO VENDORN TFR+ Saudi Arabian Monetary A uthority HEAD OFFICE RIYADH EX Rate : SAR 1.0000000 TRF FROM:SAUDI ARABIA,NONREF,Transfer,26/12/2024,"94,235.40",,14:28,26/12/2024,"55,292,992.83"
24906286,وزارة المالية TRANSFER TO VENDORN TFR+ Saudi Arabian Monetary A uthority HEAD OFFICE RIYADH EX Rate : SAR 1.0000000 TRF FROM:SAUDI ARABIA,NONREF,Transfer,26/12/2024,"141,392.00",,14:22,26/12/2024,"55,198,757.43"
24906284,وزارة المالية TRANSFER TO VENDORN TFR+ Saudi Arabian Monetary A uthority HEAD OFFICE RIYADH EX Rate : SAR 1.0000000 TRF FROM:SAUDI ARABIA,NONREF,Transfer,26/12/2024,"73,404.80",,14:22,26/12/2024,"55,057,365.43"
25262112,وزارة المالية TRANSFER TO VENDORN TFR+ Saudi Arabian Monetary A uthority HEAD OFFICE RIYADH EX Rate : SAR 1.0000000 TRF FROM:SAUDI ARABIA,NONREF,Transfer,26/12/2024,"10,630.40",,14:22,26/12/2024,"54,983,960.63"
25047948,وزارة المالية TRANSFER TO VENDORN TFR+ Saudi Arabian Monetary A uthority HEAD OFFICE RIYADH EX Rate : SAR 1.0000000 TRF FROM:SAUDI ARABIA,NONREF,Transfer,26/12/2024,"13,548.80",,14:22,26/12/2024,"54,973,330.23"
25047455,وزارة المالية TRANSFER TO VENDORN TFR+ Saudi Arabian Monetary A uthority HEAD OFFICE RIYADH EX Rate : SAR 1.0000000 TRF FROM:SAUDI ARABIA,NONREF,Transfer,26/12/2024,"24,752.00",,14:22,26/12/2024,"54,959,781.43"
25047449,وزارة المالية TRANSFER TO VENDORN TFR+ Saudi Arabian Monetary A uthority HEAD OFFICE RIYADH EX Rate : SAR 1.0000000 TRF FROM:SAUDI ARABIA,NONREF,Transfer,26/12/2024,"160,848.00",,14:22,26/12/2024,"54,935,029.43"
25325091,وزارة المالية TRANSFER TO VENDORN TFR+ Saudi Arabian Monetary A uthority HEAD OFFICE RIYADH EX Rate : SAR 1.0000000 TRF FROM:SAUDI ARABIA,NONREF,Transfer,26/12/2024,"110,311.40",,14:22,26/12/2024,"54,774,181.43"
25323037,وزارة المالية TRANSFER TO VENDORN TFR+ Saudi Arabian Monetary A uthority HEAD OFFICE RIYADH EX Rate : SAR 1.0000000 TRF FROM:SAUDI ARABIA,NONREF,Transfer,26/12/2024,"9,000.00",,14:22,26/12/2024,"54,663,870.03"
9002H9XOGELP,SINOPEC INTL PETROLEUM C TFR+,INTEGRATED,Transfer,26/12/2024,"72,121.62",,13:59,26/12/2024,"54,654,870.03"
9001N8SFEMY5,SINOPEC INTL PETROLEUM C TFR+,INTEGRATED,Transfer,26/12/2024,"217,350.00",,13:59,26/12/2024,"54,582,748.41"
24906287,وزارة المالية TRANSFER TO VENDORN TFR+ Saudi Arabian Monetary A uthority HEAD OFFICE RIYADH EX Rate : SAR 1.0000000 TRF FROM:SAUDI ARABIA,NONREF,Transfer,26/12/2024,"21,208.80",,13:47,26/12/2024,"54,365,398.41"
24906285,وزارة المالية TRANSFER TO VENDORN TFR+ Saudi Arabian Monetary A uthority HEAD OFFICE RIYADH EX Rate : SAR 1.0000000 TRF FROM:SAUDI ARABIA,NONREF,Transfer,26/12/2024,"11,010.72",,13:47,26/12/2024,"54,344,189.61"
25262113,وزارة المالية TRANSFER TO VENDORN TFR+ Saudi Arabian Monetary A uthority HEAD OFFICE RIYADH EX Rate : SAR 1.0000000 TRF FROM:SAUDI ARABIA,NONREF,Transfer,26/12/2024,"1,594.56",,13:47,26/12/2024,"54,333,178.89"
25325092,وزارة المالية TRANSFER TO VENDORN TFR+ Saudi Arabian Monetary A uthority HEAD OFFICE RIYADH EX Rate : SAR 1.0000000 TRF FROM:SAUDI ARABIA,NONREF,Transfer,26/12/2024,"16,546.71",,13:47,26/12/2024,"54,331,584.33"
25326188,وزارة المالية TRANSFER TO VENDORN TFR+ Saudi Arabian Monetary A uthority HEAD OFFICE RIYADH EX Rate : SAR 1.0000000 TRF FROM:SAUDI ARABIA,NONREF,Transfer,26/12/2024,"34,439.40",,13:47,26/12/2024,"54,315,037.62"
25326187,وزارة المالية TRANSFER TO VENDORN TFR+ Saudi Arabian Monetary A uthority HEAD OFFICE RIYADH EX Rate : SAR 1.0000000 TRF FROM:SAUDI ARABIA,NONREF,Transfer,26/12/2024,"229,596.00",,13:47,26/12/2024,"54,280,598.22"
25047949,وزارة المالية TRANSFER TO VENDORN TFR+ Saudi Arabian Monetary A uthority HEAD OFFICE RIYADH EX Rate : SAR 1.0000000 TRF FROM:SAUDI ARABIA,NONREF,Transfer,26/12/2024,"2,032.32",,13:45,26/12/2024,"54,051,002.22"
25047470,وزارة المالية TRANSFER TO VENDORN TFR+ Saudi Arabian Monetary A uthority HEAD OFFICE RIYADH EX Rate : SAR 1.0000000 TRF FROM:SAUDI ARABIA,NONREF,Transfer,26/12/2024,"4,808.64",,13:45,26/12/2024,"54,048,969.90"
25047468,وزارة المالية TRANSFER TO VENDORN TFR+ Saudi Arabian Monetary A uthority HEAD OFFICE RIYADH EX Rate : SAR 1.0000000 TRF FROM:SAUDI ARABIA,NONREF,Transfer,26/12/2024,"4,274.40",,13:45,26/12/2024,"54,044,161.26"
22288768,وزارة المالية TRANSFER TO VENDORN TFR+ Saudi Arabian Monetary A uthority HEAD OFFICE RIYADH EX Rate : SAR 1.0000000 TRF FROM:SAUDI ARABIA,NONREF,Transfer,26/12/2024,"15,420.00",,13:45,26/12/2024,"54,039,886.86"
25047466,وزارة المالية TRANSFER TO VENDORN TFR+ Saudi Arabian Monetary A uthority HEAD OFFICE RIYADH EX Rate : SAR 1.0000000 TRF FROM:SAUDI ARABIA,NONREF,Transfer,26/12/2024,"2,575.20",,13:37,26/12/2024,"54,024,466.86"
25047463,وزارة المالية TRANSFER TO VENDORN TFR+ Saudi Arabian Monetary A uthority HEAD OFFICE RIYADH EX Rate : SAR 1.0000000 TRF FROM:SAUDI ARABIA,NONREF,Transfer,26/12/2024,"2,860.32",,13:37,26/12/2024,"54,021,891.66"
25047450,وزارة المالية TRANSFER TO VENDORN TFR+ Saudi Arabian Monetary A uthority HEAD OFFICE RIYADH EX Rate : SAR 1.0000000 TRF FROM:SAUDI ARABIA,NONREF,Transfer,26/12/2024,"24,127.20",,13:37,26/12/2024,"54,019,031.34"
24769542,وزارة المالية TRANSFER TO VENDORN TFR+ Saudi Arabian Monetary A uthority HEAD OFFICE RIYADH EX Rate : SAR 1.0000000 TRF FROM:SAUDI ARABIA,NONREF,Transfer,26/12/2024,"57,061.44",,13:37,26/12/2024,"53,994,904.14"
24952967,وزارة المالية TRANSFER TO VENDORN TFR+ Saudi Arabian Monetary A uthority HEAD OFFICE RIYADH EX Rate : SAR 1.0000000 TRF FROM:SAUDI ARABIA,NONREF,Transfer,26/12/2024,"32,525.10",,13:37,26/12/2024,"53,937,842.70"
25047456,وزارة المالية TRANSFER TO VENDORN TFR+ Saudi Arabian Monetary A uthority HEAD OFFICE RIYADH EX Rate : SAR 1.0000000 TRF FROM:SAUDI ARABIA,NONREF,Transfer,26/12/2024,"3,712.80",,13:37,26/12/2024,"53,905,317.60"
25323038,وزارة المالية TRANSFER TO VENDORN TFR+ Saudi Arabian Monetary A uthority HEAD OFFICE RIYADH EX Rate : SAR 1.0000000 TRF FROM:SAUDI ARABIA,NONREF,Transfer,26/12/2024,"1,350.00",,13:37,26/12/2024,"53,901,604.80"
24936541,وزارة المالية TRANSFER TO VENDORN TFR+ Saudi Arabian Monetary A uthority HEAD OFFICE RIYADH EX Rate : SAR 1.0000000 TRF FROM:SAUDI ARABIA,NONREF,Transfer,26/12/2024,"18,519.30",,13:37,26/12/2024,"53,900,254.80"
25118075,وزارة المالية TRANSFER TO VENDORN TFR+ Saudi Arabian Monetary A uthority HEAD OFFICE RIYADH EX Rate : SAR 1.0000000 TRF FROM:SAUDI ARABIA,NONREF,Transfer,26/12/2024,"53,793.78",,13:37,26/12/2024,"53,881,735.50"
25118073,وزارة المالية TRANSFER TO VENDORN TFR+ Saudi Arabian Monetary A uthority HEAD OFFICE RIYADH EX Rate : SAR 1.0000000 TRF FROM:SAUDI ARABIA,NONREF,Transfer,26/12/2024,"154,492.89",,13:37,26/12/2024,"53,827,941.72"
25118071,وزارة المالية TRANSFER TO VENDORN TFR+ Saudi Arabian Monetary A uthority HEAD OFFICE RIYADH EX Rate : SAR 1.0000000 TRF FROM:SAUDI ARABIA,NONREF,Transfer,26/12/2024,"16,391.81",,13:37,26/12/2024,"53,673,448.83"
25118101,وزارة المالية TRANSFER TO VENDORN TFR+ Saudi Arabian Monetary A uthority HEAD OFFICE RIYADH EX Rate : SAR 1.0000000 TRF FROM:SAUDI ARABIA,NONREF,Transfer,26/12/2024,"53,793.78",,13:37,26/12/2024,"53,657,057.02"
25118061,وزارة المالية TRANSFER TO VENDORN TFR+ Saudi Arabian Monetary A uthority HEAD OFFICE RIYADH EX Rate : SAR 1.0000000 TRF FROM:SAUDI ARABIA,NONREF,Transfer,26/12/2024,"17,406.45",,13:37,26/12/2024,"53,603,263.24"
127172100ZKJ,THYSSENKRUPP SAUDI ARABI TFR+,"INTERNET, HIDC",Transfer,26/12/2024,"238,831.62",,13:18,26/12/2024,"53,585,856.79"
22288767,وزارة المالية TRANSFER TO VENDORN TFR+ Saudi Arabian Monetary A uthority HEAD OFFICE RIYADH EX Rate : SAR 1.0000000 TRF FROM:SAUDI ARABIA,NONREF,Transfer,26/12/2024,"102,800.00",,13:18,26/12/2024,"53,347,025.17"
25047469,وزارة المالية TRANSFER TO VENDORN TFR+ Saudi Arabian Monetary A uthority HEAD OFFICE RIYADH EX Rate : SAR 1.0000000 TRF FROM:SAUDI ARABIA,NONREF,Transfer,26/12/2024,"32,057.60",,13:18,26/12/2024,"53,244,225.17"
25047467,وزارة المالية TRANSFER TO VENDORN TFR+ Saudi Arabian Monetary A uthority HEAD OFFICE RIYADH EX Rate : SAR 1.0000000 TRF FROM:SAUDI ARABIA,NONREF,Transfer,26/12/2024,"28,496.00",,13:18,26/12/2024,"53,212,167.57"
25047464,وزارة المالية TRANSFER TO VENDORN TFR+ Saudi Arabian Monetary A uthority HEAD OFFICE RIYADH EX Rate : SAR 1.0000000 TRF FROM:SAUDI ARABIA,NONREF,Transfer,26/12/2024,"17,168.00",,13:18,26/12/2024,"53,183,671.57"
25047462,وزارة المالية TRANSFER TO VENDORN TFR+ Saudi Arabian Monetary A uthority HEAD OFFICE RIYADH EX Rate : SAR 1.0000000 TRF FROM:SAUDI ARABIA,NONREF,Transfer,26/12/2024,"19,068.80",,13:17,26/12/2024,"53,166,503.57"
24769541,وزارة المالية TRANSFER TO VENDORN TFR+ Saudi Arabian Monetary A uthority HEAD OFFICE RIYADH EX Rate : SAR 1.0000000 TRF FROM:SAUDI ARABIA,NONREF,Transfer,26/12/2024,"489,777.36",,13:17,26/12/2024,"53,147,434.77"
24952966,وزارة المالية TRANSFER TO VENDORN TFR+ Saudi Arabian Monetary A uthority HEAD OFFICE RIYADH EX Rate : SAR 1.0000000 TRF FROM:SAUDI ARABIA,NONREF,Transfer,26/12/2024,"216,834.00",,13:17,26/12/2024,"52,657,657.41"
24936540,وزارة المالية TRANSFER TO VENDORN TFR+ Saudi Arabian Monetary A uthority HEAD OFFICE RIYADH EX Rate : SAR 1.0000000 TRF FROM:SAUDI ARABIA,NONREF,Transfer,26/12/2024,"123,462.00",,13:17,26/12/2024,"52,440,823.41"
25118100,وزارة المالية TRANSFER TO VENDORN TFR+ Saudi Arabian Monetary A uthority HEAD OFFICE RIYADH EX Rate : SAR 1.0000000 TRF FROM:SAUDI ARABIA,NONREF,Transfer,26/12/2024,"358,625.22",,13:17,26/12/2024,"52,317,361.41"
25118074,وزارة المالية TRANSFER TO VENDORN TFR+ Saudi Arabian Monetary A uthority HEAD OFFICE RIYADH EX Rate : SAR 1.0000000 TRF FROM:SAUDI ARABIA,NONREF,Transfer,26/12/2024,"358,625.22",,13:17,26/12/2024,"51,958,736.19"
25118072,وزارة المالية TRANSFER TO VENDORN TFR+ Saudi Arabian Monetary A uthority HEAD OFFICE RIYADH EX Rate : SAR 1.0000000 TRF FROM:SAUDI ARABIA,NONREF,Transfer,26/12/2024,"1,029,952.64",,13:17,26/12/2024,"51,600,110.97"
25118070,وزارة المالية TRANSFER TO VENDORN TFR+ Saudi Arabian Monetary A uthority HEAD OFFICE RIYADH EX Rate : SAR 1.0000000 TRF FROM:SAUDI ARABIA,NONREF,Transfer,26/12/2024,"109,278.72",,13:17,26/12/2024,"50,570,158.33"
25118060,وزارة المالية TRANSFER TO VENDORN TFR+ Saudi Arabian Monetary A uthority HEAD OFFICE RIYADH EX Rate : SAR 1.0000000 TRF FROM:SAUDI ARABIA,NONREF,Transfer,26/12/2024,"97,752.12",,13:17,26/12/2024,"50,460,879.61"
YRTI-52731,LP IPSP2400M5KQL Company AL-ARBEH LASNAA SA0865000000202758585001 The Saudi Investment Ban k RIYADH 20241226SASIBCSIBC6BCIB11311547048 26DEC24 13:12:06,NONREF,Transfer,26/12/2024,"15,706.77",,13:12,26/12/2024,"50,363,127.49"
4576721020TO,BR OF CHINA PETROLEUM TFR+,QRTB24101000088,Transfer,26/12/2024,"82,800.00",,12:14,26/12/2024,"50,347,420.72"
25117421,وزارة المالية TRANSFER TO VENDORN TFR+ Saudi Arabian Monetary A uthority HEAD OFFICE RIYADH EX Rate : SAR 1.0000000 TRF FROM:SAUDI ARABIA,NONREF,Transfer,26/12/2024,"53,793.78",,12:12,26/12/2024,"50,264,620.72"
24792523,وزارة المالية TRANSFER TO VENDORN TFR+ Saudi Arabian Monetary A uthority HEAD OFFICE RIYADH EX Rate : SAR 1.0000000 TRF FROM:SAUDI ARABIA,NONREF,Transfer,26/12/2024,"215,100.00",,12:12,26/12/2024,"50,210,826.94"
24221139,وزارة المالية TRANSFER TO VENDORN TFR+ Saudi Arabian Monetary A uthority HEAD OFFICE RIYADH EX Rate : SAR 1.0000000 TRF FROM:SAUDI ARABIA,NONREF,Transfer,26/12/2024,"19,653.60",,12:12,26/12/2024,"49,995,726.94"
24221076,وزارة المالية TRANSFER TO VENDORN TFR+ Saudi Arabian Monetary A uthority HEAD OFFICE RIYADH EX Rate : SAR 1.0000000 TRF FROM:SAUDI ARABIA,NONREF,Transfer,26/12/2024,"29,676.00",,12:12,26/12/2024,"49,976,073.34"
24221073,وزارة المالية TRANSFER TO VENDORN TFR+ Saudi Arabian Monetary A uthority HEAD OFFICE RIYADH EX Rate : SAR 1.0000000 TRF FROM:SAUDI ARABIA,NONREF,Transfer,26/12/2024,"878,464.92",,12:12,26/12/2024,"49,946,397.34"
24952886,وزارة المالية TRANSFER TO VENDORN TFR+ Saudi Arabian Monetary A uthority HEAD OFFICE RIYADH EX Rate : SAR 1.0000000 TRF FROM:SAUDI ARABIA,NONREF,Transfer,26/12/2024,"32,525.10",,12:12,26/12/2024,"49,067,932.42"
24792521,وزارة المالية TRANSFER TO VENDORN TFR+ Saudi Arabian Monetary A uthority HEAD OFFICE RIYADH EX Rate : SAR 1.0000000 TRF FROM:SAUDI ARABIA,NONREF,Transfer,26/12/2024,"1,434,000.00",,12:06,26/12/2024,"49,035,407.32"
24952885,وزارة المالية TRANSFER TO VENDORN TFR+ Saudi Arabian Monetary A uthority HEAD OFFICE RIYADH EX Rate : SAR 1.0000000 TRF FROM:SAUDI ARABIA,NONREF,Transfer,26/12/2024,"216,834.00",,12:06,26/12/2024,"47,601,407.32"
24221138,وزارة المالية TRANSFER TO VENDORN TFR+ Saudi Arabian Monetary A uthority HEAD OFFICE RIYADH EX Rate : SAR 1.0000000 TRF FROM:SAUDI ARABIA,NONREF,Transfer,26/12/2024,"131,024.00",,12:06,26/12/2024,"47,384,573.32"
24221075,وزارة المالية TRANSFER TO VENDORN TFR+ Saudi Arabian Monetary A uthority HEAD OFFICE RIYADH EX Rate : SAR 1.0000000 TRF FROM:SAUDI ARABIA,NONREF,Transfer,26/12/2024,"197,840.00",,12:06,26/12/2024,"47,253,549.32"
24221072,وزارة المالية TRANSFER TO VENDORN TFR+ Saudi Arabian Monetary A uthority HEAD OFFICE RIYADH EX Rate : SAR 1.0000000 TRF FROM:SAUDI ARABIA,NONREF,Transfer,26/12/2024,"5,856,432.80",,12:06,26/12/2024,"47,055,709.32"
25117420,وزارة المالية TRANSFER TO VENDORN TFR+ Saudi Arabian Monetary A uthority HEAD OFFICE RIYADH EX Rate : SAR 1.0000000 TRF FROM:SAUDI ARABIA,NONREF,Transfer,26/12/2024,"358,625.22",,12:06,26/12/2024,"41,199,276.52"
24277306,وزارة المالية TRANSFER TO VENDORN TFR+ Saudi Arabian Monetary A uthority HEAD OFFICE RIYADH EX Rate : SAR 1.0000000 TRF FROM:SAUDI ARABIA,NONREF,Transfer,26/12/2024,"40,870.00",,12:05,26/12/2024,"40,840,651.30"
24936896,وزارة المالية TRANSFER TO VENDORN TFR+ Saudi Arabian Monetary A uthority HEAD OFFICE RIYADH EX Rate : SAR 1.0000000 TRF FROM:SAUDI ARABIA,NONREF,Transfer,26/12/2024,"181,467.10",,12:05,26/12/2024,"40,799,781.30"
24936538,وزارة المالية TRANSFER TO VENDORN TFR+ Saudi Arabian Monetary A uthority HEAD OFFICE RIYADH EX Rate : SAR 1.0000000 TRF FROM:SAUDI ARABIA,NONREF,Transfer,26/12/2024,"229,596.00",,12:05,26/12/2024,"40,618,314.20"
24936201,وزارة المالية TRANSFER TO VENDORN TFR+ Saudi Arabian Monetary A uthority HEAD OFFICE RIYADH EX Rate : SAR 1.0000000 TRF FROM:SAUDI ARABIA,NONREF,Transfer,26/12/2024,"123,462.00",,12:05,26/12/2024,"40,388,718.20"
24936199,وزارة المالية TRANSFER TO VENDORN TFR+ Saudi Arabian Monetary A uthority HEAD OFFICE RIYADH EX Rate : SAR 1.0000000 TRF FROM:SAUDI ARABIA,NONREF,Transfer,26/12/2024,"123,462.00",,12:05,26/12/2024,"40,265,256.20"
516472101D5B,BR OF CHINA PETROLEUM TFR+,NGCPB24120400113,Transfer,26/12/2024,"241,500.00",,11:57,26/12/2024,"40,141,794.20"
24840015,وزارة المالية TRANSFER TO VENDORN TFR+ Saudi Arabian Monetary A uthority HEAD OFFICE RIYADH EX Rate : SAR 1.0000000 TRF FROM:SAUDI ARABIA,NONREF,Transfer,26/12/2024,"120,416.00",,11:57,26/12/2024,"39,900,294.20"
25192023,وزارة المالية TRANSFER TO VENDORN TFR+ Saudi Arabian Monetary A uthority HEAD OFFICE RIYADH EX Rate : SAR 1.0000000 TRF FROM:SAUDI ARABIA,NONREF,Transfer,26/12/2024,"290,403.99",,11:57,26/12/2024,"39,779,878.20"
24593094,وزارة المالية TRANSFER TO VENDORN TFR+ Saudi Arabian Monetary A uthority HEAD OFFICE RIYADH EX Rate : SAR 1.0000000 TRF FROM:SAUDI ARABIA,NONREF,Transfer,26/12/2024,"200,912.00",,11:57,26/12/2024,"39,489,474.21"
24879608,وزارة المالية TRANSFER TO VENDORN TFR+ Saudi Arabian Monetary A uthority HEAD OFFICE RIYADH EX Rate : SAR 1.0000000 TRF FROM:SAUDI ARABIA,NONREF,Transfer,26/12/2024,"18,408.00",,11:57,26/12/2024,"39,288,562.21"
24792471,وزارة المالية TRANSFER TO VENDORN TFR+ Saudi Arabian Monetary A uthority HEAD OFFICE RIYADH EX Rate : SAR 1.0000000 TRF FROM:SAUDI ARABIA,NONREF,Transfer,26/12/2024,"324,932.00",,11:57,26/12/2024,"39,270,154.21"
25117418,وزارة المالية TRANSFER TO VENDORN TFR+ Saudi Arabian Monetary A uthority HEAD OFFICE RIYADH EX Rate : SAR 1.0000000 TRF FROM:SAUDI ARABIA,NONREF,Transfer,26/12/2024,"287,590.02",,11:57,26/12/2024,"38,945,222.21"
YRTI-44297,LP IPSP2400M51DQ ABDULLAH FAHAD AHMED ALM SA9280000452608010073768 Alrajhi Bank RIYADH 20241226SARJHIRJHI2BOPF11135412675 26DEC24 11:35:26,NONREF,Transfer,26/12/2024,"3,500.00",,11:35,26/12/2024,"38,657,632.19"
24277308,وزارة المالية TRANSFER TO VENDORN TFR+ Saudi Arabian Monetary A uthority HEAD OFFICE RIYADH EX Rate : SAR 1.0000000 TRF FROM:SAUDI ARABIA,NONREF,Transfer,26/12/2024,"6,130.50",,11:30,26/12/2024,"38,654,132.19"
24936897,وزارة المالية TRANSFER TO VENDORN TFR+ Saudi Arabian Monetary A uthority HEAD OFFICE RIYADH EX Rate : SAR 1.0000000 TRF FROM:SAUDI ARABIA,NONREF,Transfer,26/12/2024,"9,073.36",,11:29,26/12/2024,"38,648,001.69"
24936539,وزارة المالية TRANSFER TO VENDORN TFR+ Saudi Arabian Monetary A uthority HEAD OFFICE RIYADH EX Rate : SAR 1.0000000 TRF FROM:SAUDI ARABIA,NONREF,Transfer,26/12/2024,"34,439.40",,11:29,26/12/2024,"38,638,928.33"
24936202,وزارة المالية TRANSFER TO VENDORN TFR+ Saudi Arabian Monetary A uthority HEAD OFFICE RIYADH EX Rate : SAR 1.0000000 TRF FROM:SAUDI ARABIA,NONREF,Transfer,26/12/2024,"18,519.30",,11:29,26/12/2024,"38,604,488.93"
24936200,وزارة المالية TRANSFER TO VENDORN TFR+ Saudi Arabian Monetary A uthority HEAD OFFICE RIYADH EX Rate : SAR 1.0000000 TRF FROM:SAUDI ARABIA,NONREF,Transfer,26/12/2024,"18,519.30",,11:29,26/12/2024,"38,585,969.63"
9466836109512BA0,ركة ناصر سعيد الهاجرى وشركاه للمقا عيد الهاجرى وشركاه للمقا purchase/Products/Goods TFR+ AGAINST INVOICES RIYAD BANK HEAD OFFICE RIYADH EX Rate : SAR 1.0000000,NONREF,Transfer,26/12/2024,"151,800.00",,11:21,26/12/2024,"38,567,450.33"
9466836109512B6K,ركةمزارع فقيه للدواجن مساهمة مقفلة قيه للدواجن مساهمة مقفلة أخرى / مصروفات TFR+ تسويق الجنوب والرياض قيمة انترنت مك RIYAD BANK HEAD OFFICE RIYADH,NONREF,Transfer,26/12/2024,"36,225.00",,11:15,26/12/2024,"38,415,650.33"
YRTI-41596,LP IPSP2400M4V5D ه تقنية التشغيل المتطوره SA7010000013670568000101 Saudi National Bank JEDDAH 20241226SANCBKNCBK6B82411106753270 26DEC24 11:06:42,NONREF,Transfer,26/12/2024,"15,663.00",,11:06,26/12/2024,"38,379,425.33"
4361177DC0028705,ALBABTAIN POWER AND TELECOMMUNICA ALBABTAIN POWER AND TE شراء بضااع أو أصول TFR+ ARAB NATIONAL BANK RIYADH BRANCH EX Rate : SAR 1.0000000 0108002602600142,NONREF,Transfer,26/12/2024,"96,337.80",,10:56,26/12/2024,"38,363,762.33"
25192024,وزارة المالية TRANSFER TO VENDORN TFR+ Saudi Arabian Monetary A uthority HEAD OFFICE RIYADH EX Rate : SAR 1.0000000 TRF FROM:SAUDI ARABIA,NONREF,Transfer,26/12/2024,"43,560.59",,10:55,26/12/2024,"38,267,424.53"
24593093,وزارة المالية TRANSFER TO VENDORN TFR+ Saudi Arabian Monetary A uthority HEAD OFFICE RIYADH EX Rate : SAR 1.0000000 TRF FROM:SAUDI ARABIA,NONREF,Transfer,26/12/2024,"30,136.80",,10:55,26/12/2024,"38,223,863.94"
24879609,وزارة المالية TRANSFER TO VENDORN TFR+ Saudi Arabian Monetary A uthority HEAD OFFICE RIYADH EX Rate : SAR 1.0000000 TRF FROM:SAUDI ARABIA,NONREF,Transfer,26/12/2024,"2,761.20",,10:55,26/12/2024,"38,193,727.14"
24792487,وزارة المالية TRANSFER TO VENDORN TFR+ Saudi Arabian Monetary A uthority HEAD OFFICE RIYADH EX Rate : SAR 1.0000000 TRF FROM:SAUDI ARABIA,NONREF,Transfer,26/12/2024,"48,739.80",,10:55,26/12/2024,"38,190,965.94"
24277267,وزارة المالية TRANSFER TO VENDORN TFR+ Saudi Arabian Monetary A uthority HEAD OFFICE RIYADH EX Rate : SAR 1.0000000 TRF FROM:SAUDI ARABIA,NONREF,Transfer,26/12/2024,"5,787.75",,10:55,26/12/2024,"38,142,226.14"
24277265,وزارة المالية TRANSFER TO VENDORN TFR+ Saudi Arabian Monetary A uthority HEAD OFFICE RIYADH EX Rate : SAR 1.0000000 TRF FROM:SAUDI ARABIA,NONREF,Transfer,26/12/2024,"5,402.70",,10:55,26/12/2024,"38,136,438.39"
24277259,وزارة المالية TRANSFER TO VENDORN TFR+ Saudi Arabian Monetary A uthority HEAD OFFICE RIYADH EX Rate : SAR 1.0000000 TRF FROM:SAUDI ARABIA,NONREF,Transfer,26/12/2024,"2,254.00",,10:55,26/12/2024,"38,131,035.69"
25117419,وزارة المالية TRANSFER TO VENDORN TFR+ Saudi Arabian Monetary A uthority HEAD OFFICE RIYADH EX Rate : SAR 1.0000000 TRF FROM:SAUDI ARABIA,NONREF,Transfer,26/12/2024,"43,138.50",,10:55,26/12/2024,"38,128,781.69"
YRTI-40420,LP IPSP2400M4S5W تنظيم المعا رض المحدودة SA9205000068202002300000 Alinma bank RIYADH 20241226SAINMAINMA6BXXX11053253100 26DEC24 10:54:03,NONREF,Transfer,26/12/2024,"12,481.52",,10:54,26/12/2024,"38,085,643.19"
24840016,وزارة المالية TRANSFER TO VENDORN TFR+ Saudi Arabian Monetary A uthority HEAD OFFICE RIYADH EX Rate : SAR 1.0000000 TRF FROM:SAUDI ARABIA,NONREF,Transfer,26/12/2024,"18,062.40",,10:53,26/12/2024,"38,073,161.67"
20782717,وزارة المالية TRANSFER TO VENDORN TFR+ Saudi Arabian Monetary A uthority HEAD OFFICE RIYADH EX Rate : SAR 1.0000000 TRF FROM:SAUDI ARABIA,NONREF,Transfer,26/12/2024,"6,470.47",,10:53,26/12/2024,"38,055,099.27"
24277263,وزارة المالية TRANSFER TO VENDORN TFR+ Saudi Arabian Monetary A uthority HEAD OFFICE RIYADH EX Rate : SAR 1.0000000 TRF FROM:SAUDI ARABIA,NONREF,Transfer,26/12/2024,"5,402.70",,10:53,26/12/2024,"38,048,628.80"
24277261,وزارة المالية TRANSFER TO VENDORN TFR+ Saudi Arabian Monetary A uthority HEAD OFFICE RIYADH EX Rate : SAR 1.0000000 TRF FROM:SAUDI ARABIA,NONREF,Transfer,26/12/2024,"5,402.70",,10:53,26/12/2024,"38,043,226.10"
20782716,وزارة المالية TRANSFER TO VENDORN TFR+ Saudi Arabian Monetary A uthority HEAD OFFICE RIYADH EX Rate : SAR 1.0000000 TRF FROM:SAUDI ARABIA,NONREF,Transfer,26/12/2024,"43,136.50",,10:40,26/12/2024,"38,037,823.40"
24277266,وزارة المالية TRANSFER TO VENDORN TFR+ Saudi Arabian Monetary A uthority HEAD OFFICE RIYADH EX Rate : SAR 1.0000000 TRF FROM:SAUDI ARABIA,NONREF,Transfer,26/12/2024,"38,585.00",,10:40,26/12/2024,"37,994,686.90"
24277264,وزارة المالية TRANSFER TO VENDORN TFR+ Saudi Arabian Monetary A uthority HEAD OFFICE RIYADH EX Rate : SAR 1.0000000 TRF FROM:SAUDI ARABIA,NONREF,Transfer,26/12/2024,"36,018.00",,10:40,26/12/2024,"37,956,101.90"
24277262,وزارة المالية TRANSFER TO VENDORN TFR+ Saudi Arabian Monetary A uthority HEAD OFFICE RIYADH EX Rate : SAR 1.0000000 TRF FROM:SAUDI ARABIA,NONREF,Transfer,26/12/2024,"36,018.00",,10:40,26/12/2024,"37,920,083.90"
24277260,وزارة المالية TRANSFER TO VENDORN TFR+ Saudi Arabian Monetary A uthority HEAD OFFICE RIYADH EX Rate : SAR 1.0000000 TRF FROM:SAUDI ARABIA,NONREF,Transfer,26/12/2024,"36,018.00",,10:40,26/12/2024,"37,884,065.90"
24277258,وزارة المالية TRANSFER TO VENDORN TFR+ Saudi Arabian Monetary A uthority HEAD OFFICE RIYADH EX Rate : SAR 1.0000000 TRF FROM:SAUDI ARABIA,NONREF,Transfer,26/12/2024,"15,026.66",,10:40,26/12/2024,"37,848,047.90"
NCBK82424361ALWF,ركة أدكس للمقاولات والصيانة والتشغ لمقاولات والصيانة والتشغ Operating Expenses TFR+ Operational Maintenance NATIONAL COMMERCIAL BANK NATIONAL COMMERCIAL BANK EX Rate : SAR 1.0000000,NONREF,Transfer,26/12/2024,"27,945.00",,10:24,26/12/2024,"37,833,021.24"
5.00003E+11,RAPCO FOR CONTRACTING AND INDUSTRIA TFR+ AL RAJHI BANKING AND INV T CORP HEAD OFFICE RIYADH EX Rate : SAR 1.0000000 SA5880000183608010171444 TRF FROM:SAUDI ARABIA,NONREF,Transfer,26/12/2024,"113,677.50",,9:50,26/12/2024,"37,805,076.24"
EPHR981243615DBI,SAUDI HEALTH SCIENCES COMPANY SAUDI HEALTH SCIENCES CO سيبسسيب TFR+ BANQUE SAUDI FRANSI HEAD OFFICE RIYADH EX Rate : SAR 1.0000000 SA5655000000096751900190,NONREF,Transfer,26/12/2024,"24,777.90",,9:49,26/12/2024,"37,691,398.74"
ALMARAI COMPANY,INV241011248621 TFR+,1.00015E+13,Transfer,26/12/2024,"5,175.00",,9:22,26/12/2024,"37,666,620.84"
NCBK82424360AYSG,شركة دراية المالية مساهمه مقفله TFR+ فواتير خدمات NATIONAL COMMERCIAL BANK NATIONAL COMMERCIAL BANK EX Rate : SAR 1.0000000 29447022000104 TRF FROM:SAUDI ARABIA,NONREF,Transfer,26/12/2024,"890,148.26",,8:17,26/12/2024,"37,661,445.84"
LP CPM4055WN,"CHARGES SAR 7.00 756271Z002O7 CORP OPS DIV RIYADH TOTAL VAT SAR1,05 ON CHARGE AMOUNT SAR7,",INTER CO 197,Charges,26/12/2024,,-8.05,8:13,26/12/2024,"36,771,297.58"
LP CPM4055WN,INTEGRATED MOBILE TELECOM CO. LTD 756271Z002O7 BANQUE SAUDI FRANSI CORP OPS DIV RIYADH EX Rate : SAR 1.0000000 BANQUE SAUDI FRANSI TRF TO:SAUDI ARABIA,INTER CO 197,Transfer,26/12/2024,,"-11,000,000.00",8:13,26/12/2024,"36,771,305.63"
NCBK82424360BCBS,INNOVATION SA TFR+ Service/Utility Bills Oct24 - Dec24 Invoice Payment NATIONAL COMMERCIAL BANK NATIONAL COMMERCIAL BANK EX Rate : SAR 1.0000000 58900001291705,NONREF,Transfer,26/12/2024,"75,382.50",,7:55,26/12/2024,"47,771,305.63"
ECOF41225H001499,FRASER SUITES RIYADH مصاريف تشغيلية TFR+ Three months BANK AL-JAZIRA HEAD OFFICE JEDDAH EX Rate : SAR 1.0000000 SA8660000000302594736002 TRF FROM:SAUDI ARABIA,NONREF,Transfer,26/12/2024,"69,000.00",,4:59,26/12/2024,"47,695,923.13"
FT24358476873909,MILLENNIUM COPTHORNE MIDDLE EST HOL MILLENNIUM COPTHORNE MID SETTLEMENT OF BILLS TFR+ TT2929 ITC SALAM BANK AL BILAD BANK AL BILAD EX Rate : SAR 1.0000000,NONREF,Transfer,26/12/2024,"129,375.00",,4:47,26/12/2024,"47,626,923.13"
NCBK82424360BAOB,زمزم بولمان المدينة مصاريف تشغيل TFR+ فواتير خدمات NATIONAL COMMERCIAL BANK NATIONAL COMMERCIAL BANK EX Rate : SAR 1.0000000 33460872000107 TRF FROM:SAUDI ARABIA,NONREF,Transfer,26/12/2024,"30,360.00",,4:46,26/12/2024,"47,497,548.13"
HEAD41224AQ76622,ON DIGITAL COMPUTER SOLUTION CO. ON DIGITAL COMPUTER SOLU ITC SERVICES PAYMENT TFR+ AHLI UNITED BANK BSC AHLI UNITED BANK (BAHRAI N) BSC EX Rate : SAR 1.0000000,NONREF,Transfer,25/12/2024,"30,000.00",,18:53,25/12/2024,"47,467,188.13"
24969538,وزارة المالية TRANSFER TO VENDORN TFR+ Saudi Arabian Monetary A uthority HEAD OFFICE RIYADH EX Rate : SAR 1.0000000 TRF FROM:SAUDI ARABIA,NONREF,Transfer,25/12/2024,"64,536.00",,15:23,25/12/2024,"47,437,188.13"
25066785,وزارة المالية TRANSFER TO VENDORN TFR+ Saudi Arabian Monetary A uthority HEAD OFFICE RIYADH EX Rate : SAR 1.0000000 TRF FROM:SAUDI ARABIA,NONREF,Transfer,25/12/2024,"103,052.33",,15:23,25/12/2024,"47,372,652.13"
24969536,وزارة المالية TRANSFER TO VENDORN TFR+ Saudi Arabian Monetary A uthority HEAD OFFICE RIYADH EX Rate : SAR 1.0000000 TRF FROM:SAUDI ARABIA,NONREF,Transfer,25/12/2024,"430,240.00",,15:23,25/12/2024,"47,269,599.80"
5.00003E+11,DORA AL OLAYA HOTEL COMPANY DORA AL OLAYA HOTEL COMP /33/Repayment of Loans TFR+ INTB0234676666910033912E4C250649 AL RAJHI BANKING AND INV T CORP HEAD OFFICE RIYADH,NONREF,Transfer,25/12/2024,"20,285.48",,15:22,25/12/2024,"46,839,359.80"
YRTI-35300,LP IPSP2400M0WF4 لسعودية العربية المحدودة SA0510000005516500000110 Saudi National Bank JEDDAH 20241225SANCBKNCBK6B82411520692434 25DEC24 15:21:03,NONREF,Transfer,25/12/2024,"4,674.75",,15:21,25/12/2024,"46,819,074.32"
2.60997E+15,L+T HYDROCARBON SAUDI TFR+ 8600-4860148962-2024,860022541S228029,Transfer,25/12/2024,"7,702.91",,15:08,25/12/2024,"46,814,399.57"
YRTI-33625,LP IPSP2400M0SRX ELECTRONIC WASTE TREATME SA9660000000060675912001 Bank Aljazira JEDDAH 20241225SABJAZBJAZ2BTMS11449909112 25DEC24 14:49:59,NONREF,Transfer,25/12/2024,"15,069.60",,14:49,25/12/2024,"46,806,696.66"
3.29868E+15,L+T HYDROCARBON SAUDI TFR+ 8600-4860149300-2024,860022541S227979,Transfer,25/12/2024,"18,400.00",,14:44,25/12/2024,"46,791,627.06"
4641720006TD,ACE GALLAGHER ARABIA CO TFR+,NONREF,Transfer,25/12/2024,"30,794.33",,14:33,25/12/2024,"46,773,227.06"
25034000,وزارة المالية TRANSFER TO VENDORN TFR+ Saudi Arabian Monetary A uthority HEAD OFFICE RIYADH EX Rate : SAR 1.0000000 TRF FROM:SAUDI ARABIA,NONREF,Transfer,25/12/2024,"81,170.40",,13:58,25/12/2024,"46,742,432.73"
25033999,وزارة المالية TRANSFER TO VENDORN TFR+ Saudi Arabian Monetary A uthority HEAD OFFICE RIYADH EX Rate : SAR 1.0000000 TRF FROM:SAUDI ARABIA,NONREF,Transfer,25/12/2024,"541,136.00",,13:58,25/12/2024,"46,661,262.33"
24947488,وزارة المالية TRANSFER TO VENDORN TFR+ Saudi Arabian Monetary A uthority HEAD OFFICE RIYADH EX Rate : SAR 1.0000000 TRF FROM:SAUDI ARABIA,NONREF,Transfer,25/12/2024,"124,416.00",,13:57,25/12/2024,"46,120,126.33"
24947487,وزارة المالية TRANSFER TO VENDORN TFR+ Saudi Arabian Monetary A uthority HEAD OFFICE RIYADH EX Rate : SAR 1.0000000 TRF FROM:SAUDI ARABIA,NONREF,Transfer,25/12/2024,"829,440.00",,13:51,25/12/2024,"45,995,710.33"
NCBK82824360AUKG,عبدالرحمن عواد العنزي TFR+ /PHONBEN/ /TELEBEN/ NATIONAL COMMERCIAL BANK NATIONAL COMMERCIAL BANK EX Rate : SAR 1.0000000 36000000107402,NONREF,Transfer,25/12/2024,"40,562.00",,13:48,25/12/2024,"45,166,270.33"
NCBK82424360ARPK,شركة نيارة المحدوده TFR+ كامل قيمة بضاعه جاهزة NATIONAL COMMERCIAL BANK NATIONAL COMMERCIAL BANK EX Rate : SAR 1.0000000 24940240000110 TRF FROM:SAUDI ARABIA,NONREF,Transfer,25/12/2024,"43,125.00",,13:48,25/12/2024,"45,125,708.33"
EBBD-05449,FROM ALKHALIJIAH FOR CON PAYMENT 4 TH Q INVOICE PAYMENT 4 TH Q INVOICES,NONREF,Transfer,25/12/2024,"129,308.00",,13:34,25/12/2024,"45,082,583.33"
NCBK82424360AQXT,شركة صلب ستيل للتجارة Operating Expenses TFR+ Operational Maintenance 5th Installment as agreed NATIONAL COMMERCIAL BANK NATIONAL COMMERCIAL BANK EX Rate : SAR 1.0000000 95400006246409,NONREF,Transfer,25/12/2024,"26,277.77",,13:14,25/12/2024,"44,953,275.33"
P133599231EBPLUS,ALINMA MEDICAL SERVICES COMPANIES FOR TO IMPORTE TFR+ARAB NATIONAL BANK RIYADH BRANCHEX Rate : SAR 1.0000000 0108050581580146TRF FROM:SAUDI ARABIA 8244 ق الدااري الشرقي الف,NONREF,Transfer,25/12/2024,"75,127.20",,13:07,25/12/2024,"44,926,997.56"
P133599301EBPLUS,ALINMA MEDICAL SERVICES COMPANIES FOR OTHER PURP TFR+ 1-10-2024 4 202-10 -30م الى فاتورة انترنت من ARAB NATIONAL BANK RIYADH BRANCH EX Rate : SAR 1.0000000 0108050581580298,NONREF,Transfer,25/12/2024,"18,781.80",,13:07,25/12/2024,"44,851,870.36"
100171S017MH,DEVELOPED SUPPLIES COMPA TFR+,2.0191E+11,Transfer,25/12/2024,"30,642.90",,12:21,25/12/2024,"44,833,088.56"
1604FT243608JPWQ,لشركة السعودية للأنظمة الالكترونية TFR+ لات المتكاملة SETTLEMENT OF BILL ALINMA BANK ALINMA BANK EX Rate : SAR 1.0000000 SA1805000068202138416000,NONREF,Transfer,25/12/2024,"55,900.00",,11:58,25/12/2024,"44,802,445.66"
NCBK82424360AMLK,GLOBAL TECH EST. شراء بضاعة TFR+ قيمة دفعة لبضاعة جاهزة NATIONAL COMMERCIAL BAN NATIONAL COMMERCIAL BANK EX Rate : SAR 1.0000000 98400002766300 TRF FROM:SAUDI ARABIA,NONREF,Transfer,25/12/2024,"90,631.50",,10:58,25/12/2024,"44,746,545.66"
946683600951256M,ركة سفراء الايواء الفندقية شركة شخ TFR+ O2 and Q3 and Q4 CY Payment RIYAD BANK HEAD OFFICE RIYADH EX Rate : SAR 1.0000000 SA4320000002972827129941,NONREF,Transfer,25/12/2024,"372,600.00",,10:57,25/12/2024,"44,655,914.16"
1604FT243592K1FF,LUXURY HOTELS INTERNATIONAL L.L.C LUXURY HOTELS INTERNATIO 23173487262409304 APRIL TFR+ IMPORT GOODS ALINMA BANK ALINMA BANK EX Rate : SAR 1.0000000,NONREF,Transfer,25/12/2024,"579,600.00",,10:23,25/12/2024,"44,283,314.16"
1604FT243594Q9VM,LUXURY HOTELS INTERNATIONAL L.L.C LUXURY HOTELS INTERNATIO 23173487262409305 JAN AN TFR+ IMPORT GOODS ALINMA BANK ALINMA BANK EX Rate : SAR 1.0000000,NONREF,Transfer,25/12/2024,"316,250.00",,10:22,25/12/2024,"43,703,714.16"
1604FT24359WPNPR,FAS FIRST FOR HOTELS CO. 23173504683427600 TFR+ SETTLEMENT OF BILL ALINMA BANK ALINMA BANK EX Rate : SAR 1.0000000 SA1405000068200860036000 TRF FROM:SAUDI ARABIA,NONREF,Transfer,25/12/2024,"34,672.50",,10:22,25/12/2024,"43,387,464.16"
NCBK82424359AMCL,ركه الشبكات للاتصالات وتقنية المعل TFR+ Service/Utility Bills NATIONAL COMMERCIAL BANK NATIONAL COMMERCIAL BANK EX Rate : SAR 1.0000000 22348230000102 TRF FROM:SAUDI ARABIA,NONREF,Transfer,25/12/2024,"150,000.00",,10:06,25/12/2024,"43,352,791.66"
4.35468E+15,AL WAFI ALTAKAMUL TFR+,4.19551E+15,Transfer,25/12/2024,"7,507.20",,22:40,25/12/2024,"43,202,791.66"
XE34-00045,DC ADVISING COMM TRANSFER CHARGE ILC-0842-24-6948 -00,NONREF,Transfer,24/12/2024,,-287.5,16:22,24/12/2024,"43,195,284.46"
23843383,وزارة المالية TRANSFER TO VENDORN TFR+ Saudi Arabian Monetary A uthority HEAD OFFICE RIYADH EX Rate : SAR 1.0000000 TRF FROM:SAUDI ARABIA,NONREF,Transfer,24/12/2024,"262,386.00",,16:06,24/12/2024,"43,195,571.96"
24876892,وزارة المالية TRANSFER TO VENDORN TFR+ Saudi Arabian Monetary A uthority HEAD OFFICE RIYADH EX Rate : SAR 1.0000000 TRF FROM:SAUDI ARABIA,NONREF,Transfer,24/12/2024,"405,200.00",,16:05,24/12/2024,"42,933,185.96"
9007997Z7NE5,BUPA VENDOR PAYMENTS TFR+,130000856,Transfer,24/12/2024,"1,662,420.57",,15:30,24/12/2024,"42,527,985.96"
5.00003E+11,INTERNATIONAL DIGITAL LEADERSHIP CO INTERNATIONAL DIGITAL LE INTB0218704705005553337E TFR+ AL RAJHI BANKING AND INV T CORP HEAD OFFICE RIYADH EX Rate : SAR 1.0000000,NONREF,Transfer,24/12/2024,"89,010.00",,14:47,24/12/2024,"40,865,565.39"
25047827,وزارة المالية TRANSFER TO VENDORN TFR+ Saudi Arabian Monetary A uthority HEAD OFFICE RIYADH EX Rate : SAR 1.0000000 TRF FROM:SAUDI ARABIA,NONREF,Transfer,24/12/2024,"271,136.63",,14:33,24/12/2024,"40,776,555.39"
24220965,وزارة المالية TRANSFER TO VENDORN TFR+ Saudi Arabian Monetary A uthority HEAD OFFICE RIYADH EX Rate : SAR 1.0000000 TRF FROM:SAUDI ARABIA,NONREF,Transfer,24/12/2024,"51,998.88",,14:33,24/12/2024,"40,505,418.76"
24947292,وزارة المالية TRANSFER TO VENDORN TFR+ Saudi Arabian Monetary A uthority HEAD OFFICE RIYADH EX Rate : SAR 1.0000000 TRF FROM:SAUDI ARABIA,NONREF,Transfer,24/12/2024,"26,122.50",,14:33,24/12/2024,"40,453,419.88"
24947290,وزارة المالية TRANSFER TO VENDORN TFR+ Saudi Arabian Monetary A uthority HEAD OFFICE RIYADH EX Rate : SAR 1.0000000 TRF FROM:SAUDI ARABIA,NONREF,Transfer,24/12/2024,"26,122.50",,14:33,24/12/2024,"40,427,297.38"
25047826,وزارة المالية TRANSFER TO VENDORN TFR+ Saudi Arabian Monetary A uthority HEAD OFFICE RIYADH EX Rate : SAR 1.0000000 TRF FROM:SAUDI ARABIA,NONREF,Transfer,24/12/2024,"1,446,062.00",,14:32,24/12/2024,"40,401,174.88"
24220964,وزارة المالية TRANSFER TO VENDORN TFR+ Saudi Arabian Monetary A uthority HEAD OFFICE RIYADH EX Rate : SAR 1.0000000 TRF FROM:SAUDI ARABIA,NONREF,Transfer,24/12/2024,"346,659.20",,14:32,24/12/2024,"38,955,112.88"
24947291,وزارة المالية TRANSFER TO VENDORN TFR+ Saudi Arabian Monetary A uthority HEAD OFFICE RIYADH EX Rate : SAR 1.0000000 TRF FROM:SAUDI ARABIA,NONREF,Transfer,24/12/2024,"174,150.00",,14:32,24/12/2024,"38,608,453.68"
24947289,وزارة المالية TRANSFER TO VENDORN TFR+ Saudi Arabian Monetary A uthority HEAD OFFICE RIYADH EX Rate : SAR 1.0000000 TRF FROM:SAUDI ARABIA,NONREF,Transfer,24/12/2024,"174,150.00",,14:32,24/12/2024,"38,434,303.68"
23843384,وزارة المالية TRANSFER TO VENDORN TFR+ Saudi Arabian Monetary A uthority HEAD OFFICE RIYADH EX Rate : SAR 1.0000000 TRF FROM:SAUDI ARABIA,NONREF,Transfer,24/12/2024,"39,357.90",,14:12,24/12/2024,"38,260,153.68"
YRTI-22918,LP IPSP2400LXBJQ INTERNATIONAL DIGITAL LE SA0580000500608015553337 Alrajhi Bank RIYADH 20241224SARJHIRJHI6BOPF11409947914 24DEC24 14:09:45,NONREF,Transfer,24/12/2024,"12,834.00",,14:09,24/12/2024,"38,220,795.78"
037871Y008DU,SELA COMPANY TFR+,12/12/2024,Transfer,24/12/2024,"7,302.86",,13:34,24/12/2024,"38,207,961.78"
YRTI-20963,LP IPSP2400LX78I NATIONAL SHIPPING AGENCI SA3665000000202444133001 The Saudi Investment Ban k RIYADH 20241224SASIBCSIBC6BCIB11329512234 24DEC24 13:29:32,NONREF,Transfer,24/12/2024,"3,118.80",,13:29,24/12/2024,"38,200,658.92"
24951679,وزارة المالية TRANSFER TO VENDORN TFR+ Saudi Arabian Monetary A uthority HEAD OFFICE RIYADH EX Rate : SAR 1.0000000 TRF FROM:SAUDI ARABIA,NONREF,Transfer,24/12/2024,"11,874.24",,13:23,24/12/2024,"38,197,540.12"
24561076,وزارة المالية TRANSFER TO VENDORN TFR+ Saudi Arabian Monetary A uthority HEAD OFFICE RIYADH EX Rate : SAR 1.0000000 TRF FROM:SAUDI ARABIA,NONREF,Transfer,24/12/2024,"28,362.72",,13:23,24/12/2024,"38,185,665.88"
24876893,وزارة المالية TRANSFER TO VENDORN TFR+ Saudi Arabian Monetary A uthority HEAD OFFICE RIYADH EX Rate : SAR 1.0000000 TRF FROM:SAUDI ARABIA,NONREF,Transfer,24/12/2024,"60,780.00",,13:23,24/12/2024,"38,157,303.16"
24876887,وزارة المالية TRANSFER TO VENDORN TFR+ Saudi Arabian Monetary A uthority HEAD OFFICE RIYADH EX Rate : SAR 1.0000000 TRF FROM:SAUDI ARABIA,NONREF,Transfer,24/12/2024,"117,279.03",,13:23,24/12/2024,"38,096,523.16"
24951678,وزارة المالية TRANSFER TO VENDORN TFR+ Saudi Arabian Monetary A uthority HEAD OFFICE RIYADH EX Rate : SAR 1.0000000 TRF FROM:SAUDI ARABIA,NONREF,Transfer,24/12/2024,"237,484.86",,13:21,24/12/2024,"37,979,244.13"
24561075,وزارة المالية TRANSFER TO VENDORN TFR+ Saudi Arabian Monetary A uthority HEAD OFFICE RIYADH EX Rate : SAR 1.0000000 TRF FROM:SAUDI ARABIA,NONREF,Transfer,24/12/2024,"189,084.80",,13:21,24/12/2024,"37,741,759.27"
24876886,وزارة المالية TRANSFER TO VENDORN TFR+ Saudi Arabian Monetary A uthority HEAD OFFICE RIYADH EX Rate : SAR 1.0000000 TRF FROM:SAUDI ARABIA,NONREF,Transfer,24/12/2024,"781,860.22",,13:21,24/12/2024,"37,552,674.47"
900185LQDE11,SAUDI COMPANY FOR ARTIFI TFR+,856,Transfer,24/12/2024,"226,685.70",,13:21,24/12/2024,"36,770,814.25"
NCBK9812435906PQ,"NEOM Company Operating Expenses TFR+ NATIONAL COMMERCIAL BANK NATIONAL COMMERCIAL BANK EX Rate : SAR 1.0000000 19500000007210 TRF FROM:SAUDI ARABIA ALKHURAYBAH ST,ALKHURAYBA DIST,4964",NONREF,Transfer,24/12/2024,"658,382.95",,13:13,24/12/2024,"36,544,128.55"
197571T01XMS,SAUDI CINEMA COMPANY LLC TFR+,2400000910,Transfer,24/12/2024,"672,591.30",,13:01,24/12/2024,"35,885,745.60"
1604FT243591WDQ3,لمعهد العالي النسااي للسياحة والضي لي النسااي للسياحة والضي 23173503332167300 PAYMEN TFR+ COUNT HTMI SETTLEMENT OF BILL ALINMA BANK ALINMA BANK,NONREF,Transfer,24/12/2024,"36,800.00",,13:00,24/12/2024,"35,213,154.30"
1604FT24359F1JFY,لمعهد العالي النسااي للسياحة والضي لي النسااي للسياحة والضي 23173503344808500 PAYMEN TFR+ COUNT MENA CO SETTLEMENT OF BILL ALINMA BANK ALINMA BANK,NONREF,Transfer,24/12/2024,"57,500.00",,13:00,24/12/2024,"35,176,354.30"
1604FT24359GGPB5,ZONE CONNECT CO 23173503258684100 SET IN TFR+ 4837 SETTLEMENT OF BILL ALINMA BANK ALINMA BANK EX Rate : SAR 1.0000000 SA1205000068204724931002,NONREF,Transfer,24/12/2024,"20,780.50",,12:45,24/12/2024,"35,118,854.30"
200GBCS243590676,ARBN TRDG SUPY (R) TFR+ GULF INTERNATIONAL BANK BSC RIYADH EX Rate : SAR 1.0000000 SA1990000339788999261001 TRF FROM:SAUDI ARABIA,NONREF,Transfer,24/12/2024,"202,339.17",,12:34,24/12/2024,"35,098,073.80"
22323574,وزارة المالية TRANSFER TO VENDORN TFR+ Saudi Arabian Monetary A uthority HEAD OFFICE RIYADH EX Rate : SAR 1.0000000 TRF FROM:SAUDI ARABIA,NONREF,Transfer,24/12/2024,"31,030.40",,12:25,24/12/2024,"34,895,734.63"
NCBK9812435905W8,Sadad Collection Account for Enfor- Sadad Collection Account 401014502103472 TFR+ NATIONAL COMMERCIAL BANK NATIONAL COMMERCIAL BANK EX Rate : SAR 1.0000000 79453142895607,NONREF,Transfer,24/12/2024,"1,500.00",,12:18,24/12/2024,"34,864,704.23"
NCBK9812435905WO,Sadad Collection Account for Enfor- Sadad Collection Account 401014502105006 TFR+ NATIONAL COMMERCIAL BANK NATIONAL COMMERCIAL BANK EX Rate : SAR 1.0000000 79453143299209,NONREF,Transfer,24/12/2024,"1,500.00",,12:18,24/12/2024,"34,863,204.23"
22323575,وزارة المالية TRANSFER TO VENDORN TFR+ Saudi Arabian Monetary A uthority HEAD OFFICE RIYADH EX Rate : SAR 1.0000000 TRF FROM:SAUDI ARABIA,NONREF,Transfer,24/12/2024,"4,654.56",,12:17,24/12/2024,"34,861,704.23"
NCBK82824359ANLJ,رياض ملهي العريفي Operating Expenses TFR+ /PHONBEN/ /TELEBEN/ NATIONAL COMMERCIAL BANK NATIONAL COMMERCIAL BANK EX Rate : SAR 1.0000000 13550848000109,NONREF,Transfer,24/12/2024,"25,000.00",,11:50,24/12/2024,"34,857,049.67"
V241224111132789,401014602290890 :تنفيذ قضااى 401014602290890 :ذ قضااى /99/16810722 TFR+ AL RAJHI BANKING AND INV T CORP HEAD OFFICE RIYADH EX Rate : SAR 1.0000000,NONREF,Transfer,24/12/2024,0.22,,11:47,24/12/2024,"34,832,049.67"
YRTI-16148,LP IPSP2400LWV6S world hotel hospitality SA2080000139608016214615 Alrajhi Bank RIYADH 20241224SARJHIRJHI6BOPF11146668851 24DEC24 11:46:38,NONREF,Transfer,24/12/2024,"9,660.00",,11:46,24/12/2024,"34,832,049.45"
23877353,وزارة المالية TRANSFER TO VENDORN TFR+ Saudi Arabian Monetary A uthority HEAD OFFICE RIYADH EX Rate : SAR 1.0000000 TRF FROM:SAUDI ARABIA,NONREF,Transfer,24/12/2024,"3,830.88",,11:43,24/12/2024,"34,822,389.45"
24724938,وزارة المالية TRANSFER TO VENDORN TFR+ Saudi Arabian Monetary A uthority HEAD OFFICE RIYADH EX Rate : SAR 1.0000000 TRF FROM:SAUDI ARABIA,NONREF,Transfer,24/12/2024,"133,115.40",,11:43,24/12/2024,"34,818,558.57"
25113135,وزارة المالية TRANSFER TO VENDORN TFR+ Saudi Arabian Monetary A uthority HEAD OFFICE RIYADH EX Rate : SAR 1.0000000 TRF FROM:SAUDI ARABIA,NONREF,Transfer,24/12/2024,"21,402.45",,11:43,24/12/2024,"34,685,443.17"
24878643,وزارة المالية TRANSFER TO VENDORN TFR+ Saudi Arabian Monetary A uthority HEAD OFFICE RIYADH EX Rate : SAR 1.0000000 TRF FROM:SAUDI ARABIA,NONREF,Transfer,24/12/2024,"21,402.45",,11:42,24/12/2024,"34,664,040.72"
24876901,وزارة المالية TRANSFER TO VENDORN TFR+ Saudi Arabian Monetary A uthority HEAD OFFICE RIYADH EX Rate : SAR 1.0000000 TRF FROM:SAUDI ARABIA,NONREF,Transfer,24/12/2024,"53,793.78",,11:42,24/12/2024,"34,642,638.27"
24876899,وزارة المالية TRANSFER TO VENDORN TFR+ Saudi Arabian Monetary A uthority HEAD OFFICE RIYADH EX Rate : SAR 1.0000000 TRF FROM:SAUDI ARABIA,NONREF,Transfer,24/12/2024,"53,793.78",,11:42,24/12/2024,"34,588,844.49"
24792196,وزارة المالية TRANSFER TO VENDORN TFR+ Saudi Arabian Monetary A uthority HEAD OFFICE RIYADH EX Rate : SAR 1.0000000 TRF FROM:SAUDI ARABIA,NONREF,Transfer,24/12/2024,"34,351.20",,11:42,24/12/2024,"34,535,050.71"
24876897,وزارة المالية TRANSFER TO VENDORN TFR+ Saudi Arabian Monetary A uthority HEAD OFFICE RIYADH EX Rate : SAR 1.0000000 TRF FROM:SAUDI ARABIA,NONREF,Transfer,24/12/2024,"53,793.78",,11:42,24/12/2024,"34,500,699.51"
24792195,وزارة المالية TRANSFER TO VENDORN TFR+ Saudi Arabian Monetary A uthority HEAD OFFICE RIYADH EX Rate : SAR 1.0000000 TRF FROM:SAUDI ARABIA,NONREF,Transfer,24/12/2024,"229,008.00",,11:42,24/12/2024,"34,446,905.73"
25113134,وزارة المالية TRANSFER TO VENDORN TFR+ Saudi Arabian Monetary A uthority HEAD OFFICE RIYADH EX Rate : SAR 1.0000000 TRF FROM:SAUDI ARABIA,NONREF,Transfer,24/12/2024,"142,683.00",,11:42,24/12/2024,"34,217,897.73"
24878642,وزارة المالية TRANSFER TO VENDORN TFR+ Saudi Arabian Monetary A uthority HEAD OFFICE RIYADH EX Rate : SAR 1.0000000 TRF FROM:SAUDI ARABIA,NONREF,Transfer,24/12/2024,"142,683.00",,11:42,24/12/2024,"34,075,214.73"
24876898,وزارة المالية TRANSFER TO VENDORN TFR+ Saudi Arabian Monetary A uthority HEAD OFFICE RIYADH EX Rate : SAR 1.0000000 TRF FROM:SAUDI ARABIA,NONREF,Transfer,24/12/2024,"358,625.22",,11:42,24/12/2024,"33,932,531.73"
23877352,وزارة المالية TRANSFER TO VENDORN TFR+ Saudi Arabian Monetary A uthority HEAD OFFICE RIYADH EX Rate : SAR 1.0000000 TRF FROM:SAUDI ARABIA,NONREF,Transfer,24/12/2024,"25,539.20",,11:39,24/12/2024,"33,573,906.51"
24724937,وزارة المالية TRANSFER TO VENDORN TFR+ Saudi Arabian Monetary A uthority HEAD OFFICE RIYADH EX Rate : SAR 1.0000000 TRF FROM:SAUDI ARABIA,NONREF,Transfer,24/12/2024,"887,436.00",,11:39,24/12/2024,"33,548,367.31"
24876900,وزارة المالية TRANSFER TO VENDORN TFR+ Saudi Arabian Monetary A uthority HEAD OFFICE RIYADH EX Rate : SAR 1.0000000 TRF FROM:SAUDI ARABIA,NONREF,Transfer,24/12/2024,"358,625.22",,11:39,24/12/2024,"32,660,931.31"
24876896,وزارة المالية TRANSFER TO VENDORN TFR+ Saudi Arabian Monetary A uthority HEAD OFFICE RIYADH EX Rate : SAR 1.0000000 TRF FROM:SAUDI ARABIA,NONREF,Transfer,24/12/2024,"358,625.22",,11:39,24/12/2024,"32,302,306.09"
947683590951D8XK,شركة الخزف السعودية Local Payment TFR+ RIYAD BANK HEAD OFFICE RIYADH EX Rate : SAR 1.0000000 SA8220000002970144559901 TRF FROM:SAUDI ARABIA 3893 ص .ب,NONREF,Transfer,24/12/2024,"45,540.00",,11:37,24/12/2024,"31,943,680.87"
NCBK82424358BBXF,Small and Medium Enterprises Financ Small and Medium Enterpr مصاريف تشغيل TFR+ فواتير خدمات NATIONAL COMMERCIAL BANK NATIONAL COMMERCIAL BANK EX Rate : SAR 1.0000000,NONREF,Transfer,24/12/2024,"61,479.00",,11:26,24/12/2024,"31,898,140.87"
NCBK82424358BBDR,ركه مراكز العبير الطبيه شركة ذات م العبير الطبيه شركة ذات م Operating Expenses TFR+ Operational Maintenance pmnt to integrated telecom NATIONAL COMMERCIAL BANK NATIONAL COMMERCIAL BANK,NONREF,Transfer,24/12/2024,"20,872.50",,11:25,24/12/2024,"31,836,661.87"
NCBK82424358AWTV,ركة خدمات حلول التقنية للاتصالات و TFR+ Service/Utility Bills NATIONAL COMMERCIAL BANK NATIONAL COMMERCIAL BANK EX Rate : SAR 1.0000000 22100000203204 TRF FROM:SAUDI ARABIA,NONREF,Transfer,24/12/2024,"82,000.00",,11:22,24/12/2024,"31,815,789.37"
NCBK82424358AWAY,مؤسسة نبيل التجارية Operating Expenses TFR+ Service/Utility Bills ITC Bills Qtr4 ITC Bills Qtr4 NATIONAL COMMERCIAL BANK NATIONAL COMMERCIAL BANK EX Rate : SAR 1.0000000,NONREF,Transfer,24/12/2024,"36,365.00",,11:21,24/12/2024,"31,733,789.37"
1604FT24358VGNGB,FAS SECOEND FOR HOTELS CO. FAS SECOEND FOR HOTELS C 23173486517769700 TFR+ SETTLEMENT OF BILL ALINMA BANK ALINMA BANK EX Rate : SAR 1.0000000,NONREF,Transfer,24/12/2024,"41,572.50",,11:04,24/12/2024,"31,697,424.37"
BTBF-00093,FROM MRC-SAR-OPERATIONS BTB- BTBF00093241224 INVOICE SETTLEMENT,12578,Transfer,24/12/2024,"13,524.00",,10:56,24/12/2024,"31,655,851.87"
YRTI-13771,LP IPSP2400LWPZ0 لراجحي واوﻻده لﻼستثمار SA9480000131608010380006 Alrajhi Bank RIYADH 20241224SARJHIRJHI6BOPF11053588205 24DEC24 10:53:40,NONREF,Transfer,24/12/2024,"6,900.00",,10:53,24/12/2024,"31,642,327.87"
YRTI-10911,LP IPSP2400LWKBC (لتجاري (شركة شخص واحد SA7305000068200000309000 Alinma bank RIYADH 20241224SAINMAINMA6BXXX10944251924 24DEC24 09:44:22,NONREF,Transfer,24/12/2024,"17,246.55",,9:44,24/12/2024,"31,635,427.87"
694971Y001G7,KHALID ALTURKI HOLDING C TFR+ INV240731191969 MINV00134213,SALAM/INV,Transfer,24/12/2024,"94,281.60",,9:21,24/12/2024,"31,618,181.32"
5.00003E+11,INTERNATIONAL DIGITAL LEADERSHIP CO INTERNATIONAL DIGITAL LE INTB0218704705005553337E TFR+ AL RAJHI BANKING AND INV T CORP HEAD OFFICE RIYADH EX Rate : SAR 1.0000000,NONREF,Transfer,24/12/2024,"90,275.00",,9:11,24/12/2024,"31,523,899.72"
5.00003E+11,INTERNATIONAL DIGITAL LEADERSHIP CO INTERNATIONAL DIGITAL LE INTB0218704705005553337E TFR+ AL RAJHI BANKING AND INV T CORP HEAD OFFICE RIYADH EX Rate : SAR 1.0000000,NONREF,Transfer,24/12/2024,"32,923.38",,9:11,24/12/2024,"31,433,624.72"
5.00003E+11,INTERNATIONAL DIGITAL LEADERSHIP CO INTERNATIONAL DIGITAL LE INTB0218704705005553337E TFR+ AL RAJHI BANKING AND INV T CORP HEAD OFFICE RIYADH EX Rate : SAR 1.0000000,NONREF,Transfer,24/12/2024,"89,010.00",,9:11,24/12/2024,"31,400,701.34"
LP IPSP2400LWFVW,"20241224SASABBSABB6BNET10823030762 TOT CHG SAR 1.00 AL RAJHI BANKING AND INV T CORP HEAD OFFICE RIYADH VATABLE SAR 1.00 VAT AMT SAR 0.15 STANDARD RATE AT 000000000000015 TOTAL VAT SAR0,15 ON CHARGE AMOUNT SAR1,",609685,Charges,24/12/2024,,-1.15,8:23,24/12/2024,"31,311,691.34"
LP IPSP2400LWFVW,RUIMIGUEL ARAUJONOBREGA 20241224SASABBSABB6BNET10823030762 SA5180000106608017509202AL RAJHI BANKING AND INV T CORPHEAD OFFICE RIYADH EX Rate SAR 1.0000000,609685,Transfer,24/12/2024,,"-3,103.71",8:23,24/12/2024,"31,311,692.49"
LP CPMN2YQ1VIRN,"CHARGES SAR 7.00 252271Y01KSG T CORP BR 161 JEDDAH TOTAL VAT SAR1,05 ON CHARGE AMOUNT SAR7,",609697,Charges,24/12/2024,,-8.05,8:23,24/12/2024,"31,314,796.20"
LP CPMN2YQ1VIRN,FRANCISCO DAYAPAN 252271Y01KSG /RFB/ITC CWF PAYMENT AL RAJHI BANKING AND INV T CORP BR 161 JEDDAH EX Rate : SAR 1.0000000 AL RAJHI BANKING AND INV,609697,Transfer,24/12/2024,,"-4,822.28",8:23,24/12/2024,"31,314,804.25"
TT CPMN0JON1IRNN,"CHARGES SAR 130.00 835371Y011H1 TOTAL VAT SAR19,5 ON CHARGE AMOUNT SAR130,",609619,Charges,24/12/2024,,-149.5,8:23,24/12/2024,"31,319,626.53"
TT CPMN0JON1IRNN,STC BAHRAIN BSC 835371Y011H1 EX Rate : SAR 3.7550000 AHLI UNITED BANK BSC TRF TO:BAHRAIN,609619,Transfer,24/12/2024,,"-48,083.64",8:23,24/12/2024,"31,319,776.03"
LP CPMN2YQ1UIRN,"CHARGES SAR 7.00 401371Y02270 T CORP BR 161 JEDDAH TOTAL VAT SAR1,05 ON CHARGE AMOUNT SAR7,",609620,Charges,24/12/2024,,-8.05,8:23,24/12/2024,"31,367,859.67"
LP CPMN2YQ1UIRN,ENGINEERING SCIENCE INSTITUTE 401371Y02270 AL RAJHI BANKING AND INV T CORP BR 161 JEDDAH EX Rate : SAR 1.0000000 AL RAJHI BANKING AND INV T CORP,609620,Transfer,24/12/2024,,"-31,625.00",8:23,24/12/2024,"31,367,867.72"
LP CPMN2YQ1TIRN,"CHARGES SAR 7.00 197671Y012WD ALINMA BANK TOTAL VAT SAR1,05 ON CHARGE AMOUNT SAR7,",609608,Charges,24/12/2024,,-8.05,8:23,24/12/2024,"31,399,492.72"
LP CPMN2YQ1TIRN,مؤسسة تشكيل الهواء للمقاوﻻت 197671Y012WD ALINMA BANK ALINMA BANK EX Rate : SAR 1.0000000 ALINMA BANK TRF TO:SAUDI ARABIA,609608,Transfer,24/12/2024,,"-57,261.61",8:23,24/12/2024,"31,399,500.77"
TT CPMN0JON0IRNN,"CHARGES SAR 130.00 625671Y022U7 TOTAL VAT SAR19,5 ON CHARGE AMOUNT SAR130,",609615,Charges,24/12/2024,,-149.5,8:23,24/12/2024,"31,456,762.38"
TT CPMN0JON0IRNN,COMMS COMPASS DWC LLC 625671Y022U7 MARKETING ADVISORY 2024-04 EX Rate : SAR 1.0261000 ABU DHABI ISLAMIC BANK TRF TO:UNITED ARAB EMIRA TES,609615,Transfer,24/12/2024,,"-73,000.00",8:23,24/12/2024,"31,456,911.88"
LP CPMN2YQ1SIRN,"CHARGES SAR 7.00 217171Y01Y3H EMIRATES BANK INTERNATIO NAL TOTAL VAT SAR1,05 ON CHARGE AMOUNT SAR7,",609628,Charges,24/12/2024,,-8.05,8:23,24/12/2024,"31,529,911.88"
LP CPMN2YQ1SIRN,PRICEWATERHOUSECOOPERS PUBLIC 217171Y01Y3H EMIRATES NBD BANK PJSC EMIRATES BANK INTERNATIO NAL EX Rate : SAR 1.0000000 EMIRATES NBD BANK PJSC TRF TO:SAUDI ARABIA,609628,Transfer,24/12/2024,,"-92,000.00",8:23,24/12/2024,"31,529,919.93"
588171Y01Z3O,HORIZONS EXPERTS FOR 822-087037-001,609698,Transfer,24/12/2024,,"-264,022.75",8:23,24/12/2024,"31,621,919.93"
LP CPMN2YQ1RIRN,"CHARGES SAR 7.00 633171Y00URJ KING ABDUL AZIZ ST ALHOB AR TOTAL VAT SAR1,05 ON CHARGE AMOUNT SAR7,",609603,Charges,24/12/2024,,-8.05,8:23,24/12/2024,"31,885,942.68"
LP CPMN2YQ1RIRN,HUAWEI TECH. INVESTMENT SAUDI ARABI 633171Y00URJ /RFB/ITC INVOICE PAYMENT ARAB NATIONAL BANK KING ABDUL AZIZ ST ALHOB AR EX Rate : SAR 1.0000000 ARAB NATIONAL BANK,609603,Transfer,24/12/2024,,"-656,435.68",8:23,24/12/2024,"31,885,950.73"
LP CPMN2YQ1QIRN,"CHARGES SAR 7.00 797771Y00WPT KING ABDUL AZIZ ST ALHOB AR TOTAL VAT SAR1,05 ON CHARGE AMOUNT SAR7,",609599,Charges,24/12/2024,,-8.05,8:23,24/12/2024,"32,542,386.41"
LP CPMN2YQ1QIRN,HUAWEI TECH. INVESTMENT SAUDI ARABI 797771Y00WPT /RFB/ITC INVOICE PAYMENT ARAB NATIONAL BANK KING ABDUL AZIZ ST ALHOB AR EX Rate : SAR 1.0000000 ARAB NATIONAL BANK,609599,Transfer,24/12/2024,,"-5,000,000.00",8:23,24/12/2024,"32,542,394.46"
LP CPMN2YQ1PIRN,"CHARGES SAR 7.00 762771Y00CGB KING ABDUL AZIZ ST ALHOB AR TOTAL VAT SAR1,05 ON CHARGE AMOUNT SAR7,",609601,Charges,24/12/2024,,-8.05,8:23,24/12/2024,"37,542,394.46"
LP CPMN2YQ1PIRN,HUAWEI TECH. INVESTMENT SAUDI ARABI 762771Y00CGB /RFB/ITC INVOICE PAYMENT ARAB NATIONAL BANK KING ABDUL AZIZ ST ALHOB AR EX Rate : SAR 1.0000000 ARAB NATIONAL BANK,609601,Transfer,24/12/2024,,"-5,000,000.00",8:23,24/12/2024,"37,542,402.51"
LP CPMN2YQ1OIRN,"CHARGES SAR 7.00 667471Y00I6D KING ABDUL AZIZ ST ALHOB AR TOTAL VAT SAR1,05 ON CHARGE AMOUNT SAR7,",609597,Charges,24/12/2024,,-8.05,8:23,24/12/2024,"42,542,402.51"
LP CPMN2YQ1OIRN,HUAWEI TECH. INVESTMENT SAUDI ARABI 667471Y00I6D /RFB/ITC INVOICE PAYMENT ARAB NATIONAL BANK KING ABDUL AZIZ ST ALHOB AR EX Rate : SAR 1.0000000 ARAB NATIONAL BANK,609597,Transfer,24/12/2024,,"-5,000,000.00",8:23,24/12/2024,"42,542,410.56"
9.8449E+15,BADER BADER 822-043097-001,609643,Transfer,24/12/2024,,"-2,069.10",8:20,24/12/2024,"47,542,410.56"
LP CPMC3WIOKIRC,"CHARGES SAR 7.00 9728508435890001 THE NATIONAL COMMERCIAL BANK TOTAL VAT SAR1,05 ON CHARGE AMOUNT SAR7,",609655,Charges,24/12/2024,,-8.05,8:20,24/12/2024,"47,544,479.66"
LP CPMC3WIOKIRC,MAHAMID HUSSAIN MOHAMMED 9728508435890001 NATIONAL COMMERCIAL BANK THE NATIONAL COMMERCIAL BANK EX Rate : SAR 1.0000000 NATIONAL COMMERCIAL BANK TRF TO:SAUDI ARABIA,609655,Transfer,24/12/2024,,-500,8:20,24/12/2024,"47,544,487.71"
9.72979E+15,MEETHAL ABDUL 017-244906-150,609629,Transfer,24/12/2024,,-250,8:20,24/12/2024,"47,544,987.71"
LP CPMC3WIOJIRC,"CHARGES SAR 7.00 9609128435890001 T CORP BR 161 JEDDAH TOTAL VAT SAR1,05 ON CHARGE AMOUNT SAR7,",609680,Charges,24/12/2024,,-8.05,8:20,24/12/2024,"47,545,237.71"
LP CPMC3WIOJIRC,TURKI ALZAHRANI 9609128435890001 AL RAJHI BANKING AND INV T CORP BR 161 JEDDAH EX Rate : SAR 1.0000000 AL RAJHI BANKING AND INV T CORP,609680,Transfer,24/12/2024,,"-5,600.00",8:20,24/12/2024,"47,545,245.76"
9.3051E+15,ALRUFAIDI ABDULLAH 827-000340-001,609632,Transfer,24/12/2024,,"-9,000.00",8:20,24/12/2024,"47,550,845.76"
LP CPMC3WIOIIRC,"CHARGES SAR 7.00 8731118435890001 DOLLAR CLEARING A/C JEDD AH TOTAL VAT SAR1,05 ON CHARGE AMOUNT SAR7,",609663,Charges,24/12/2024,,-8.05,8:20,24/12/2024,"47,559,845.76"
LP CPMC3WIOIIRC,MOHAMMAD ZUBAIR ABDUL GHANI 8731118435890001 BANK AL-JAZIRA DOLLAR CLEARING A/C JEDD AH EX Rate : SAR 1.0000000 BANK AL-JAZIRA TRF TO:SAUDI ARABIA,609663,Transfer,24/12/2024,,-458,8:20,24/12/2024,"47,559,853.81"
8.67331E+15,SAADEH FADI 003-599032-001,609651,Transfer,24/12/2024,,"-1,580.00",8:20,24/12/2024,"47,560,311.81"
LP CPMC3WIOHIRC,"CHARGES SAR 7.00 8545108435890001 THE NATIONAL COMMERCIAL BANK TOTAL VAT SAR1,05 ON CHARGE AMOUNT SAR7,",609648,Charges,24/12/2024,,-8.05,8:20,24/12/2024,"47,561,891.81"
LP CPMC3WIOHIRC,EMAD ALMANADILI 8545108435890001 NATIONAL COMMERCIAL BANK THE NATIONAL COMMERCIAL BANK EX Rate : SAR 1.0000000 NATIONAL COMMERCIAL BANK TRF TO:SAUDI ARABIA,609648,Transfer,24/12/2024,,"-1,500.00",8:20,24/12/2024,"47,561,899.86"
LP CPMC3WIOGIRC,"CHARGES SAR 7.00 8366408435890001 ALINMA BANK TOTAL VAT SAR1,05 ON CHARGE AMOUNT SAR7,",609653,Charges,24/12/2024,,-8.05,8:20,24/12/2024,"47,563,399.86"
LP CPMC3WIOGIRC,GHALIA ALDOSARI 8366408435890001 ALINMA BANK ALINMA BANK EX Rate : SAR 1.0000000 ALINMA BANK TRF TO:SAUDI ARABIA,609653,Transfer,24/12/2024,,"-2,000.00",8:20,24/12/2024,"47,563,407.91"
LP CPMC3WIOFIRC,"CHARGES SAR 7.00 8368597435890001 CORP OPS DIV RIYADH TOTAL VAT SAR1,05 ON CHARGE AMOUNT SAR7,",609640,Charges,24/12/2024,,-8.05,8:20,24/12/2024,"47,565,407.91"
LP CPMC3WIOFIRC,AMJAD KURDI 8368597435890001 BANQUE SAUDI FRANSI CORP OPS DIV RIYADH EX Rate : SAR 1.0000000 BANQUE SAUDI FRANSI TRF TO:SAUDI ARABIA,609640,Transfer,24/12/2024,,"-2,421.00",8:20,24/12/2024,"47,565,415.96"
LP CPMC3WIOEIRC,"CHARGES SAR 7.00 8115397435890001 THE NATIONAL COMMERCIAL BANK TOTAL VAT SAR1,05 ON CHARGE AMOUNT SAR7,",609636,Charges,24/12/2024,,-8.05,8:20,24/12/2024,"47,567,836.96"
LP CPMC3WIOEIRC,ABDULROUF ALKHUDIRI 8115397435890001 NATIONAL COMMERCIAL BANK THE NATIONAL COMMERCIAL BANK EX Rate : SAR 1.0000000 NATIONAL COMMERCIAL BANK TRF TO:SAUDI ARABIA,609636,Transfer,24/12/2024,,"-1,293.75",8:20,24/12/2024,"47,567,845.01"
LP CPMC3WIODIRC,"CHARGES SAR 7.00 8082297435890001 T CORP BR 161 JEDDAH TOTAL VAT SAR1,05 ON CHARGE AMOUNT SAR7,",609634,Charges,24/12/2024,,-8.05,8:20,24/12/2024,"47,569,138.76"
LP CPMC3WIODIRC,ABDULRAHMAN AL MUTLAQAH 8082297435890001 AL RAJHI BANKING AND INV T CORP BR 161 JEDDAH EX Rate : SAR 1.0000000 AL RAJHI BANKING AND INV T CORP,609634,Transfer,24/12/2024,,"-10,000.00",8:20,24/12/2024,"47,569,146.81"
7.7342E+15,MANDURAH ABDULLAH 181-043597-001,609633,Transfer,24/12/2024,,"-3,200.00",8:20,24/12/2024,"47,579,146.81"
LP CPMC3WIOCIRC,"CHARGES SAR 7.00 7637118435890001 THE NATIONAL COMMERCIAL BANK TOTAL VAT SAR1,05 ON CHARGE AMOUNT SAR7,",609664,Charges,24/12/2024,,-8.05,8:20,24/12/2024,"47,582,346.81"
LP CPMC3WIOCIRC,MOHAMMED A ALREHAILI 7637118435890001 NATIONAL COMMERCIAL BANK THE NATIONAL COMMERCIAL BANK EX Rate : SAR 1.0000000 NATIONAL COMMERCIAL BANK TRF TO:SAUDI ARABIA,609664,Transfer,24/12/2024,,"-4,901.00",8:20,24/12/2024,"47,582,354.86"
LP CPMC3WIOBIRC,"CHARGES SAR 7.00 6477208435890001 THE NATIONAL COMMERCIAL BANK TOTAL VAT SAR1,05 ON CHARGE AMOUNT SAR7,",609650,Charges,24/12/2024,,-8.05,8:20,24/12/2024,"47,587,255.86"
LP CPMC3WIOBIRC,EUTEQUIANO JR GALEDO 6477208435890001 NATIONAL COMMERCIAL BANK THE NATIONAL COMMERCIAL BANK EX Rate : SAR 1.0000000 NATIONAL COMMERCIAL BANK TRF TO:SAUDI ARABIA,609650,Transfer,24/12/2024,,"-3,423.00",8:20,24/12/2024,"47,587,263.91"
6.37313E+15,THAMER ALI AHMED ALJOFI 154-088736-150,609679,Transfer,24/12/2024,,"-21,000.00",8:20,24/12/2024,"47,590,686.91"
6.2826E+15,AKHTAR ALI 003-298700-150,609639,Transfer,24/12/2024,,"-15,955.00",8:20,24/12/2024,"47,611,686.91"
6.05922E+15,ALASEERI MOHAMMED 817-006489-001,609666,Transfer,24/12/2024,,"-11,685.00",8:20,24/12/2024,"47,627,641.91"
5.92171E+15,AHMED MAJID 042-139592-060,609657,Transfer,24/12/2024,,"-2,761.00",8:20,24/12/2024,"47,639,326.91"
5.70011E+15,ACHTANI DHIREN 154-235980-001,609647,Transfer,24/12/2024,,"-22,142.00",8:20,24/12/2024,"47,642,087.91"
LP CPMC3WIOAIRC,"CHARGES SAR 7.00 5694797435890001 T CORP BR 161 JEDDAH TOTAL VAT SAR1,05 ON CHARGE AMOUNT SAR7,",609642,Charges,24/12/2024,,-8.05,8:20,24/12/2024,"47,664,229.91"
LP CPMC3WIOAIRC,AZMATH MOHAMMED 5694797435890001 AL RAJHI BANKING AND INV T CORP BR 161 JEDDAH EX Rate : SAR 1.0000000 AL RAJHI BANKING AND INV T CORP,609642,Transfer,24/12/2024,,"-6,635.50",8:20,24/12/2024,"47,664,237.96"
5.14523E+15,ALSALKHADI YAHYA 010-134252-150,609681,Transfer,24/12/2024,,"-1,500.00",8:20,24/12/2024,"47,670,873.46"
LP CPMC3WIO9IRC,"CHARGES SAR 7.00 5078318435890001 ALINMA BANK TOTAL VAT SAR1,05 ON CHARGE AMOUNT SAR7,",609667,Charges,24/12/2024,,-8.05,8:20,24/12/2024,"47,672,373.46"
LP CPMC3WIO9IRC,MOHD HAMDAN 5078318435890001 ALINMA BANK ALINMA BANK EX Rate : SAR 1.0000000 ALINMA BANK TRF TO:SAUDI ARABIA,609667,Transfer,24/12/2024,,-250,8:20,24/12/2024,"47,672,381.51"
4.74482E+15,ALNJJAR SAED 155-175151-001,609674,Transfer,24/12/2024,,"-20,000.00",8:20,24/12/2024,"47,672,631.51"
LP CPMC3WIO8IRC,"CHARGES SAR 7.00 4291987435890001 ALINMA BANK TOTAL VAT SAR1,05 ON CHARGE AMOUNT SAR7,",609630,Charges,24/12/2024,,-8.05,8:20,24/12/2024,"47,692,631.51"
LP CPMC3WIO8IRC,ABDULKAREEM AL JAMEA 4291987435890001 ALINMA BANK ALINMA BANK EX Rate : SAR 1.0000000 ALINMA BANK TRF TO:SAUDI ARABIA,609630,Transfer,24/12/2024,,"-3,600.00",8:20,24/12/2024,"47,692,639.56"
LP CPMC3WIO7IRC,"CHARGES SAR 7.00 4234008435890001 BSC RIYADH TOTAL VAT SAR1,05 ON CHARGE AMOUNT SAR7,",609646,Charges,24/12/2024,,-8.05,8:20,24/12/2024,"47,696,239.56"
LP CPMC3WIO7IRC,DEMAH ALGHAMDI 4234008435890001 GULF INTERNATIONAL BANK BSC RIYADH EX Rate : SAR 1.0000000 GULF INTERNATIONAL BANK BSC,609646,Transfer,24/12/2024,,"-5,500.00",8:20,24/12/2024,"47,696,247.61"
4.20981E+15,MOHAMED ALY MOHAMED 181-262510-001,609660,Transfer,24/12/2024,,"-3,047.79",8:20,24/12/2024,"47,701,747.61"
LP CPMC3WIO6IRC,"CHARGES SAR 7.00 4056718435890001 THE NATIONAL COMMERCIAL BANK TOTAL VAT SAR1,05 ON CHARGE AMOUNT SAR7,",609673,Charges,24/12/2024,,-8.05,8:20,24/12/2024,"47,704,795.40"
LP CPMC3WIO6IRC,RAAD ALRABIGHI 4056718435890001 NATIONAL COMMERCIAL BANK THE NATIONAL COMMERCIAL BANK EX Rate : SAR 1.0000000 NATIONAL COMMERCIAL BANK TRF TO:SAUDI ARABIA,609673,Transfer,24/12/2024,,-518,8:20,24/12/2024,"47,704,803.45"
LP CPMC3WIO5IRC,"CHARGES SAR 7.00 3908618435890001 T CORP BR 161 JEDDAH TOTAL VAT SAR1,05 ON CHARGE AMOUNT SAR7,",609672,Charges,24/12/2024,,-8.05,8:20,24/12/2024,"47,705,321.45"
LP CPMC3WIO5IRC,OSAMA ALMOMANI 3908618435890001 AL RAJHI BANKING AND INV T CORP BR 161 JEDDAH EX Rate : SAR 1.0000000 AL RAJHI BANKING AND INV T CORP,609672,Transfer,24/12/2024,,"-20,000.00",8:20,24/12/2024,"47,705,329.50"
3.7505E+15,ALSHARIF AHMAD 018-069328-001,609637,Transfer,24/12/2024,,-784,8:20,24/12/2024,"47,725,329.50"
LP CPMC3WIO4IRC,"CHARGES SAR 7.00 3683808435890001 THE NATIONAL COMMERCIAL BANK TOTAL VAT SAR1,05 ON CHARGE AMOUNT SAR7,",609659,Charges,24/12/2024,,-8.05,8:20,24/12/2024,"47,726,113.50"
LP CPMC3WIO4IRC,MAZIN IBRAHIM 3683808435890001 NATIONAL COMMERCIAL BANK THE NATIONAL COMMERCIAL BANK EX Rate : SAR 1.0000000 NATIONAL COMMERCIAL BANK TRF TO:SAUDI ARABIA,609659,Transfer,24/12/2024,,"-2,016.00",8:20,24/12/2024,"47,726,121.55"
LP CPMC3WIO3IRC,"CHARGES SAR 7.00 3675997435890001 HEAD OFFICE RIYADH TOTAL VAT SAR1,05 ON CHARGE AMOUNT SAR7,",609645,Charges,24/12/2024,,-8.05,8:20,24/12/2024,"47,728,137.55"
LP CPMC3WIO3IRC,BASSAM ALANZI 3675997435890001 RIYAD BANK HEAD OFFICE RIYADH EX Rate : SAR 1.0000000 RIYAD BANK TRF TO:SAUDI ARABIA,609645,Transfer,24/12/2024,,"-3,105.00",8:20,24/12/2024,"47,728,145.60"
LP CPMC3WIO2IRC,"CHARGES SAR 7.00 3666518435890001 CORP OPS DIV RIYADH TOTAL VAT SAR1,05 ON CHARGE AMOUNT SAR7,",609670,Charges,24/12/2024,,-8.05,8:20,24/12/2024,"47,731,250.60"
LP CPMC3WIO2IRC,NAWEED HUSSAIN 3666518435890001 BANQUE SAUDI FRANSI CORP OPS DIV RIYADH EX Rate : SAR 1.0000000 BANQUE SAUDI FRANSI TRF TO:SAUDI ARABIA,609670,Transfer,24/12/2024,,-250,8:20,24/12/2024,"47,731,258.65"
3.65262E+15,ASFOUR OMAR 004-680880-001,609671,Transfer,24/12/2024,,"-10,000.00",8:20,24/12/2024,"47,731,508.65"
3.631E+15,ALAMRI BANDAR 353-324684-001,609644,Transfer,24/12/2024,,"-13,601.00",8:20,24/12/2024,"47,741,508.65"
LP CPMC3WIO1IRC,"CHARGES SAR 7.00 3577708435890001 ALINMA BANK TOTAL VAT SAR1,05 ON CHARGE AMOUNT SAR7,",609658,Charges,24/12/2024,,-8.05,8:20,24/12/2024,"47,755,109.65"
LP CPMC3WIO1IRC,MASHAEL ALMOHSEN 3577708435890001 ALINMA BANK ALINMA BANK EX Rate : SAR 1.0000000 ALINMA BANK TRF TO:SAUDI ARABIA,609658,Transfer,24/12/2024,,"-7,000.00",8:20,24/12/2024,"47,755,117.70"
LP CPMC3WIO0IRC,"CHARGES SAR 7.00 3166497435890001 THE NATIONAL COMMERCIAL BANK TOTAL VAT SAR1,05 ON CHARGE AMOUNT SAR7,",609638,Charges,24/12/2024,,-8.05,8:20,24/12/2024,"47,762,117.70"
LP CPMC3WIO0IRC,AHMED BIN SUWAIDAN 3166497435890001 NATIONAL COMMERCIAL BANK THE NATIONAL COMMERCIAL BANK EX Rate : SAR 1.0000000 NATIONAL COMMERCIAL BANK TRF TO:SAUDI ARABIA,609638,Transfer,24/12/2024,,"-15,000.00",8:20,24/12/2024,"47,762,125.75"
3.14442E+15,GHULAM MUHAMMAD 860-280726-001,609668,Transfer,24/12/2024,,-458,8:20,24/12/2024,"47,777,125.75"
LP CPMC3WINZIRC,"CHARGES SAR 7.00 3013018435890001 CORP OPS DIV RIYADH TOTAL VAT SAR1,05 ON CHARGE AMOUNT SAR7,",609662,Charges,24/12/2024,,-8.05,8:20,24/12/2024,"47,777,583.75"
LP CPMC3WINZIRC,MOHAMMAD SAFDER 3013018435890001 BANQUE SAUDI FRANSI CORP OPS DIV RIYADH EX Rate : SAR 1.0000000 BANQUE SAUDI FRANSI TRF TO:SAUDI ARABIA,609662,Transfer,24/12/2024,,-500,8:20,24/12/2024,"47,777,591.80"
LP CPMC3WINYIRC,"CHARGES SAR 7.00 2988297435890001 CORP OPS DIV RIYADH TOTAL VAT SAR1,05 ON CHARGE AMOUNT SAR7,",609635,Charges,24/12/2024,,-8.05,8:20,24/12/2024,"47,778,091.80"
LP CPMC3WINYIRC,ABDULRAHMAN ALAMRI 2988297435890001 BANQUE SAUDI FRANSI CORP OPS DIV RIYADH EX Rate : SAR 1.0000000 BANQUE SAUDI FRANSI TRF TO:SAUDI ARABIA,609635,Transfer,24/12/2024,,"-8,750.00",8:20,24/12/2024,"47,778,099.85"
LP CPMC3WINXIRC,"CHARGES SAR 7.00 2482218435890001 BANK AL BILAD TOTAL VAT SAR1,05 ON CHARGE AMOUNT SAR7,",609665,Charges,24/12/2024,,-8.05,8:20,24/12/2024,"47,786,849.85"
LP CPMC3WINXIRC,MOHAMMED AL AMRI 2482218435890001 BANK AL BILAD BANK AL BILAD EX Rate : SAR 1.0000000 BANK AL BILAD TRF TO:SAUDI ARABIA,609665,Transfer,24/12/2024,,"-2,189.00",8:20,24/12/2024,"47,786,857.90"
LP CPMC3WINWIRC,"CHARGES SAR 7.00 2370408435890001 ALINMA BANK TOTAL VAT SAR1,05 ON CHARGE AMOUNT SAR7,",609652,Charges,24/12/2024,,-8.05,8:20,24/12/2024,"47,789,046.90"
LP CPMC3WINWIRC,FAISAL ALMALKI 2370408435890001 ALINMA BANK ALINMA BANK EX Rate : SAR 1.0000000 ALINMA BANK TRF TO:SAUDI ARABIA,609652,Transfer,24/12/2024,,"-1,800.00",8:20,24/12/2024,"47,789,054.95"
1.74092E+15,YAQOOB SAJID 035-244896-150,609675,Transfer,24/12/2024,,"-4,708.00",8:20,24/12/2024,"47,790,854.95"
LP CPMC3WINVIRC,"CHARGES SAR 7.00 1564608435890001 CORP OPS DIV RIYADH TOTAL VAT SAR1,05 ON CHARGE AMOUNT SAR7,",609656,Charges,24/12/2024,,-8.05,8:20,24/12/2024,"47,795,562.95"
LP CPMC3WINVIRC,MAJED ALANAZI 1564608435890001 BANQUE SAUDI FRANSI CORP OPS DIV RIYADH EX Rate : SAR 1.0000000 BANQUE SAUDI FRANSI TRF TO:SAUDI ARABIA,609656,Transfer,24/12/2024,,"-1,334.63",8:20,24/12/2024,"47,795,571.00"
LP CPMC3WINUIRC,"CHARGES SAR 7.00 1329987435890001 CORP OPS DIV RIYADH TOTAL VAT SAR1,05 ON CHARGE AMOUNT SAR7,",609631,Charges,24/12/2024,,-8.05,8:20,24/12/2024,"47,796,905.63"
LP CPMC3WINUIRC,ABDULLAH ALFAHADI 1329987435890001 BANQUE SAUDI FRANSI CORP OPS DIV RIYADH EX Rate : SAR 1.0000000 BANQUE SAUDI FRANSI TRF TO:SAUDI ARABIA,609631,Transfer,24/12/2024,,"-3,800.00",8:20,24/12/2024,"47,796,913.68"
1.15103E+15,NADEEMUDDIN SYED 003-336203-001,609677,Transfer,24/12/2024,,"-4,481.00",8:20,24/12/2024,"47,800,713.68"
LP CPMC3WINTIRC,"CHARGES SAR 7.00 1085918435890001 T CORP BR 161 JEDDAH TOTAL VAT SAR1,05 ON CHARGE AMOUNT SAR7,",609676,Charges,24/12/2024,,-8.05,8:20,24/12/2024,"47,805,194.68"
LP CPMC3WINTIRC,SULTAN SIRAJ 1085918435890001 AL RAJHI BANKING AND INV T CORP BR 161 JEDDAH EX Rate : SAR 1.0000000 AL RAJHI BANKING AND INV T CORP,609676,Transfer,24/12/2024,,"-2,201.00",8:20,24/12/2024,"47,805,202.73"
1.06251E+15,SIDDIQUI IRFAN 003-463007-001,609654,Transfer,24/12/2024,,-500,8:20,24/12/2024,"47,807,403.73"
9.94908E+14,ALABSI MOHAMMED 860-126549-001,609661,Transfer,24/12/2024,,-250,8:20,24/12/2024,"47,807,903.73"
LP CPMC3WINSIRC,"CHARGES SAR 7.00 0887028435890001 EMIRATES BANK INTERNATIO NAL TOTAL VAT SAR1,05 ON CHARGE AMOUNT SAR7,",609678,Charges,24/12/2024,,-8.05,8:20,24/12/2024,"47,808,153.73"
LP CPMC3WINSIRC,TAREQ ZAGHLOUL 0887028435890001 EMIRATES NBD BANK PJSC EMIRATES BANK INTERNATIO NAL EX Rate : SAR 1.0000000 EMIRATES NBD BANK PJSC TRF TO:SAUDI ARABIA,609678,Transfer,24/12/2024,,"-10,000.00",8:20,24/12/2024,"47,808,161.78"
LP CPMC3WINRIRC,"CHARGES SAR 7.00 0541208435890001 CORP OPS DIV RIYADH TOTAL VAT SAR1,05 ON CHARGE AMOUNT SAR7,",609649,Charges,24/12/2024,,-8.05,8:20,24/12/2024,"47,818,161.78"
LP CPMC3WINRIRC,EMAD ALROWAISHED 0541208435890001 BANQUE SAUDI FRANSI CORP OPS DIV RIYADH EX Rate : SAR 1.0000000 BANQUE SAUDI FRANSI TRF TO:SAUDI ARABIA,609649,Transfer,24/12/2024,,"-5,000.00",8:20,24/12/2024,"47,818,169.83"
1.94697E+14,SAYED AMRO 003-040771-150,609641,Transfer,24/12/2024,,-100,8:20,24/12/2024,"47,823,169.83"
1.80518E+14,ALOTAIBI NAHIDH 808-073050-001,609669,Transfer,24/12/2024,,"-20,000.00",8:20,24/12/2024,"47,823,269.83"
542971Y00KA7,SA SABB 001-754381-004 TFR+,INTER CO 195,Transfer,24/12/2024,"6,000,000.00",,8:20,24/12/2024,"47,843,269.83"
YRTI-08206,LP IPSP2400LWF81 INTERNATIONAL DIGITAL LE SA0580000500608015553337 Alrajhi Bank RIYADH 20241224SARJHIRJHI6BOPF10809360972 24DEC24 08:09:25,NONREF,Transfer,24/12/2024,"12,834.00",,8:09,24/12/2024,"41,843,269.83"
YRTI-05965,LP IPSP2400LWB3S LEADING MODERN CO SA8360100002294099955001 Bank Aljazira JEDDAH 20241224SABJAZBJAZ2BTMS10409792615 24DEC24 04:10:08,NONREF,Transfer,24/12/2024,"17,939.00",,4:10,24/12/2024,"41,830,435.83"
189071Y0207T,BUILDINGS EFFICIENCY COM TFR+,SALAM INTEGRATED,Transfer,24/12/2024,"41,055.00",,1:11,24/12/2024,"41,812,496.83"
IPA4122300023179,1/MATHEVON MIDDLE EAST INDUSTRY LLC 1/MATHEVON MIDDLE EAST I /ROC/INTEGRATED///URI/IN TFR+ 74// BNP PARIBAS SA PARIS EX Rate : SAR 1.0000000,NONREF,Transfer,24/12/2024,"6,641.25",,22:32,24/12/2024,"41,771,441.83"
338271Y0200O,KHALIFA ALGOSAIBI COMPAN TFR+,INV:00139640,Transfer,23/12/2024,"13,920.00",,16:56,23/12/2024,"41,764,800.58"
511571Y024FS,KHALIFA ALGOSAIBI COMPAN TFR+ INV:00139640,INV:00139638,Transfer,23/12/2024,"31,610.00",,16:56,23/12/2024,"41,750,880.58"
381171Y00EFM,TECHNOLOGY PRECISION CO TFR+,NONREF,Transfer,23/12/2024,"33,596.13",,16:27,23/12/2024,"41,719,270.58"
393571Y00OVI,"SCHWEITZER ENGINEEING TFR+ INV0032935, INV0036563",INV SETTLE,Transfer,23/12/2024,"9,788.56",,16:10,23/12/2024,"41,685,674.45"
25066784,وزارة المالية TRANSFER TO VENDORN TFR+ Saudi Arabian Monetary A uthority HEAD OFFICE RIYADH EX Rate : SAR 1.0000000 TRF FROM:SAUDI ARABIA,NONREF,Transfer,23/12/2024,"687,015.23",,15:53,23/12/2024,"41,675,885.89"
YRTI-24683,LP IPSP2400LUK78 Company MAJMOU BAAN Hold SA7065000000101156654013 The Saudi Investment Ban k RIYADH 20241223SASIBCSIBC6BCIB11548494749 23DEC24 15:48:46,NONREF,Transfer,23/12/2024,400.2,,15:48,23/12/2024,"40,988,870.66"
FT24358309206800,SAR166350001 SETTLEMENT OF BILLS TFR+ CINV2406111898781 BANK AL BILAD BANK AL BILAD EX Rate : SAR 1.0000000 TRF FROM:SAUDI ARABIA,NONREF,Transfer,23/12/2024,"1,706,604.15",,15:37,23/12/2024,"40,988,470.46"
9466835809511WRZ,شركة تنامي العربية مساهمة مقفلة امي العربية مساهمة مقفلة expenses/Other TFR+ ITC Payment RIYAD BANK HEAD OFFICE RIYADH EX Rate : SAR 1.0000000,NONREF,Transfer,23/12/2024,"249,918.00",,15:26,23/12/2024,"39,281,866.31"
YRTI-23689,LP IPSP2400LUHR7 مادا من ويندام الفندقية SA7705000068204310230000 Alinma bank RIYADH 20241223SAINMAINMA6BXXX11525250897 23DEC24 15:25:25,NONREF,Transfer,23/12/2024,"18,227.67",,15:25,23/12/2024,"39,031,948.31"
4.00549E+15,TELEPERFORMANCE SAUDI TFR+,5687699888,Transfer,23/12/2024,"99,981.00",,15:09,23/12/2024,"39,013,720.64"
NCBK82424358ARRU,S.B. OF ENGI. ENPPI مصاريف تشغيل TFR+ فواتير خدمات NATIONAL COMMERCIAL BANK NATIONAL COMMERCIAL BANK EX Rate : SAR 1.0000000 95400005556907 TRF FROM:SAUDI ARABIA,NONREF,Transfer,23/12/2024,"117,182.70",,13:37,23/12/2024,"38,913,739.64"
NCBK82424358ARRT,S.B. OF ENGI. ENPPI مصاريف تشغيل TFR+ فواتير خدمات NATIONAL COMMERCIAL BANK NATIONAL COMMERCIAL BANK EX Rate : SAR 1.0000000 95400005556907 TRF FROM:SAUDI ARABIA,NONREF,Transfer,23/12/2024,"171,914.24",,13:37,23/12/2024,"38,796,556.94"
MNCJ-00031,COLLECTION حسين رافع عايش SALES ANB 62846 FRANSI 129407 ID : B 1055600660 DAM 0564080872 MAIX,NONREF,Cheque,25/12/2024,"136,608.88",,13:01,23/12/2024,"38,624,642.70"
NCBK9812435800HY,KELLOGG BROWN A ROOT LTD -ABDULLAH KELLOGG BROWN A ROOT LTD /REF/GDI/ TFR+ INV240331168248 INV241031255728 INV241131266846 NATIONAL COMMERCIAL BANK,NONREF,Transfer,23/12/2024,"431,463.90",,12:56,23/12/2024,"38,488,033.82"
SA2OL24122300033,LANDMARK ARABIA COMPANY TFR+ /Narr/BRT 1201000449 Misc Payment STANDARD CHARTERED CAPIT AL (SAUDI A STANDARD CHARTERED CAPIT AL SAUDI EX Rate : SAR 1.0000000,NONREF,Transfer,23/12/2024,"139,731.90",,12:53,23/12/2024,"38,056,569.92"
SA2OL2412230002Y,LANDMARK ARABIA COMPANY TFR+ /Narr/BRT 1201000465 Misc Payment STANDARD CHARTERED CAPIT AL (SAUDI A STANDARD CHARTERED CAPIT AL SAUDI EX Rate : SAR 1.0000000,NONREF,Transfer,23/12/2024,"151,527.45",,12:53,23/12/2024,"37,916,838.02"
259471X00SH5,ACE GALLAGHER ARABIA CO TFR+,BILLS ACE,Transfer,23/12/2024,"1,172,891.20",,12:38,23/12/2024,"37,765,310.57"
NCBK82424358APOX,AL-BARRAK EDUCATIONA Operating Expenses TFR+ Service/Utility Bills INV240831242345 month of AUG NATIONAL COMMERCIAL BANK NATIONAL COMMERCIAL BANK EX Rate : SAR 1.0000000,NONREF,Transfer,23/12/2024,"32,085.00",,12:19,23/12/2024,"36,592,419.37"
NCBK82424357AYHT,شركة بوابة العربات للسيارات TFR+ فواتير خدمات NATIONAL COMMERCIAL BANK NATIONAL COMMERCIAL BANK EX Rate : SAR 1.0000000 19100000078702 TRF FROM:SAUDI ARABIA,NONREF,Transfer,23/12/2024,"120,000.00",,9:45,23/12/2024,"36,560,334.37"
010141222H790324,Company MAJMOU BAAN Holding Company MAJMOU BAAN Hold Radisson Blu Jizan TFR+ SAUDI INVESTMENT BANK RIYADH EX Rate : SAR 1.0000000 0101 156654 029,NONREF,Transfer,23/12/2024,"27,600.00",,9:40,23/12/2024,"36,440,334.37"
NCBK82424356ANGL,ركة رابطه المدينه للتجاره والنقل ا المدينه للتجاره والنقل ا Operating Expenses TFR+ Service/Utility Bills NATIONAL COMMERCIAL BANK NATIONAL COMMERCIAL BANK EX Rate : SAR 1.0000000,NONREF,Transfer,23/12/2024,"8,625.00",,9:21,23/12/2024,"36,412,734.37"
200GTSA243570043,"ALSARH TRAVEL AND TOURISM COMPANY ALSARH TRAVEL AND TOURIS Invoice Settlement,INV 8 TFR+ 24 GULF INTERNATIONAL BANK BSC RIYADH",NONREF,Transfer,23/12/2024,"21,620.00",,9:13,23/12/2024,"36,404,109.37"
428471X013N6,EXPENSE TFR+,NONREF,Transfer,22/12/2024,"257,666.70",,17:57,22/12/2024,"36,382,489.37"
YRTI-89250,LP IPSP2400LRJGE MAHARAH HUMAN RESOURCES SA6880000114608010887761 Alrajhi Bank RIYADH 20241222SARJHIRJHI6BOPF11626618860 22DEC24 16:26:27,NONREF,Transfer,22/12/2024,"2,753.10",,16:26,22/12/2024,"36,124,822.67"
YRTI-89228,LP IPSP2400LRJG8 Company MAJMOU BAAN Hold SA6465000000101156654024 The Saudi Investment Ban k RIYADH 20241222SASIBCSIBC6BCIB11625476540 22DEC24 16:25:58,NONREF,Transfer,22/12/2024,"12,937.50",,16:25,22/12/2024,"36,122,069.57"
NCBK82424357ATWC,شركة شبكة صحارى مصاريف تشغيل TFR+ فواتير خدمات NATIONAL COMMERCIAL BANK NATIONAL COMMERCIAL BANK EX Rate : SAR 1.0000000 65911762000101 TRF FROM:SAUDI ARABIA,NONREF,Transfer,22/12/2024,"740,107.09",,15:41,22/12/2024,"36,109,132.07"
TJD6-00072,INCOME ايرادات خدمات انترنت عبدالمحسن محم NCB 154358ID : B 1043476496 JED0510018585 DANUB,NONREF,Cheque,24/12/2024,"19,320.00",,15:31,22/12/2024,"35,369,024.98"
900041222H000332,NATIONAL BANK OF KUWAIT BR NATIONAL BANK OF KUWAIT INV240711226438.6881 TFR+ RENEWAL SUBSCRIPTION FOR NBK KAS CONNECTIONS NOV 2024 NATIONAL BK OF KUWAIT SA K,NONREF,Transfer,22/12/2024,"342,217.74",,15:12,22/12/2024,"35,349,704.98"
FT24354469008822,FOUR POINTS SHIRATON HOTEL FOUR POINTS SHIRATON HOT SETTLEMENT OF BILLS TFR+ ITC INV OCT 24 TO DEC 2024 BANK AL BILAD BANK AL BILAD EX Rate : SAR 1.0000000,NONREF,Transfer,22/12/2024,"50,000.00",,15:06,22/12/2024,"35,007,487.24"
FT24354976660738,FOUR POINTS SHIRATON HOTEL FOUR POINTS SHIRATON HOT SETTLEMENT OF BILLS TFR+ ITC INV OCT 24 TO DEC 2024 BANK AL BILAD BANK AL BILAD EX Rate : SAR 1.0000000,NONREF,Transfer,22/12/2024,"24,002.50",,15:06,22/12/2024,"34,957,487.24"
144371X00Z2N,SAUDI MARITIME COMPANY TFR+ INVOICE INV241021249532 INVOICE INV241021249533,BP241201630,Transfer,22/12/2024,"10,356.90",,14:37,22/12/2024,"34,933,484.74"
010141222H789568,SAUDI FUND FOR DEVELOPMENT SAUDI FUND FOR DEVELOPME 2024 00038 93 ITC FIN AR TFR+ SAUDI INVESTMENT BANK RIYADH EX Rate : SAR 1.0000000 0101 400960 015,NONREF,Transfer,22/12/2024,"251,294.44",,14:23,22/12/2024,"34,923,127.84"
YRTI-79041,LP IPSP2400LQUHW (معلومات (شركة شخ ص واحد SA9210000027953566000107 Saudi National Bank JEDDAH 20241222SANCBKNCBK6B82411224238525 22DEC24 12:24:34,NONREF,Transfer,22/12/2024,"4,183.94",,12:24,22/12/2024,"34,671,833.40"
NCBK82424357ANUW,لشركه السعوديه للاقتصاد والتنميه ا وديه للاقتصاد والتنميه ا Operating Expenses TFR+ Service/Utility Bills NATIONAL COMMERCIAL BANK NATIONAL COMMERCIAL BANK EX Rate : SAR 1.0000000,NONREF,Transfer,22/12/2024,"2,438.61",,12:00,22/12/2024,"34,667,649.46"
NCBK82424354ATOY,DAR ALAFIA MDICAL CO TFR+ سداد دفعة دار عافية كامل قيمة بضاعه NATIONAL COMMERCIAL BANK NATIONAL COMMERCIAL BANK EX Rate : SAR 1.0000000 95400003730704,NONREF,Transfer,22/12/2024,"62,202.63",,11:18,22/12/2024,"34,665,210.85"
BTBB-00224,FROM MAC-SAR-OPERATIONS BTB- BTBB00224241222 INVOICE SETTLEMENT,327034,Transfer,22/12/2024,"13,524.00",,10:40,22/12/2024,"34,603,008.22"
9466835409511JUC,الغرفة التجارية الصناعية بالمدينة تجارية الصناعية بالمدينة أخرى / مصروفات TFR+ سداد المستحق للشركة RIYAD BANK HEAD OFFICE RIYADH EX Rate : SAR 1.0000000,NONREF,Transfer,22/12/2024,"85,560.00",,9:44,22/12/2024,"34,589,484.22"
FT24354081015882,WALID JAMEEL ALHEJAILAN AND PARTNER WALID JAMEEL ALHEJAILAN SETTLEMENT OF BILLS TFR+ INVOICES FROM JUN24 TO NOV24 BANK AL BILAD BANK AL BILAD EX Rate : SAR 1.0000000,NONREF,Transfer,22/12/2024,"110,400.00",,9:43,22/12/2024,"34,503,924.22"
NCBK82424355AKEI,ركة مزارع فقيه للدواجن مساهمة مقفل فقيه للدواجن مساهمة مقفل شراء بضاعة TFR+ كامل قيمة بضاعه جاهزة NATIONAL COMMERCIAL BANK NATIONAL COMMERCIAL BANK EX Rate : SAR 1.0000000,NONREF,Transfer,22/12/2024,"31,292.73",,9:31,22/12/2024,"34,393,524.22"
1604FT243550S224,INFOBIP CO INV241211293341 TFR+ SETTLEMENT OF BILL ALINMA BANK ALINMA BANK EX Rate : SAR 1.0000000 SA6805000068202039931000 TRF FROM:SAUDI ARABIA,NONREF,Transfer,22/12/2024,"79,184.40",,9:21,22/12/2024,"34,362,231.49"
YRTI-49968,LP IPSP2400LP8GF VALLEY ALMADINA SA6980000577608010444001 Alrajhi Bank RIYADH 20241221SARJHIRJHI6BOPF11623987468 21DEC24 16:24:04,NONREF,Transfer,22/12/2024,"1,337.56",,16:24,22/12/2024,"34,283,047.09"
8.89493E+15,L+T HYDROCARBON SAUDI TFR+ 8600-4860147305-2024,860022541S227716,Transfer,22/12/2024,"82,995.79",,9:01,22/12/2024,"34,281,709.53"
9.46882E+15,OLIVER WYMAN LIMITED TFR+,9.66005E+12,Transfer,22/12/2024,"39,823.35",,18:55,22/12/2024,"34,198,713.74"
7.93303E+15,OLIVER WYMAN LIMITED TFR+,9.66005E+12,Transfer,22/12/2024,"4,450.50",,18:55,22/12/2024,"34,158,890.39"
4.60592E+15,OLIVER WYMAN LIMITED TFR+,9.66005E+12,Transfer,22/12/2024,"4,450.50",,18:55,22/12/2024,"34,154,439.89"
4.05413E+15,OLIVER WYMAN LIMITED TFR+,9.66005E+12,Transfer,22/12/2024,"79,643.25",,18:55,22/12/2024,"34,149,989.39"
YRTI-16716,LP IPSP2400LNHBM ALMADINAH VIEW HOTEL SA6480000198608018888752 Alrajhi Bank RIYADH 20241220SARJHIRJHI6BOPF11607410736 20DEC24 16:07:41,NONREF,Transfer,22/12/2024,"17,250.00",,16:07,22/12/2024,"34,070,346.14"
YRTI-16711,LP IPSP2400LNH5P ALMADINAH VIEW HOTEL SA6480000198608018888752 Alrajhi Bank RIYADH 20241220SARJHIRJHI6BOPF11607412020 20DEC24 16:07:36,NONREF,Transfer,22/12/2024,"1,176.85",,16:07,22/12/2024,"34,053,096.14"
7.23721E+15,OLIVER WYMAN LIMITED TFR+,9.66005E+12,Transfer,22/12/2024,"150,558.00",,23:29,22/12/2024,"34,051,919.29"
805071U015ZN,HELLMANN SAUDI ARABIA TFR+,INV0045919,Transfer,19/12/2024,"2,693.43",,17:41,19/12/2024,"33,901,361.29"
816371U00GHL,HELLMANN SAUDI ARABIA TFR+,CINV241221276292,Transfer,19/12/2024,"13,144.50",,17:41,19/12/2024,"33,898,667.86"
8.99882E+15,LARSEN TOUBRO ARABIA CO TFR+ 8400-4840104762-2024,840022547S306585,Transfer,19/12/2024,"57,147.58",,15:59,19/12/2024,"33,885,523.36"
Seera Group Hold,1000150000108824 /ROC/1000150000108824/// TFR+,1.00015E+15,Transfer,19/12/2024,"68,089.20",,14:39,19/12/2024,"33,828,375.78"
NCBK82424354ARYJ,ركة الفضاء القمريه للاتصالات المحد القمريه للاتصالات المحد مصاريف تشغيل TFR+ فواتير خدمات NATIONAL COMMERCIAL BANK NATIONAL COMMERCIAL BANK EX Rate : SAR 1.0000000,NONREF,Transfer,19/12/2024,"130,000.00",,13:35,19/12/2024,"33,760,286.58"
410571U01WHZ,ARABIAN EST FOR TRD+SHIP TFR+,INV SETTLEMENT,Transfer,19/12/2024,"124,846.30",,13:28,19/12/2024,"33,630,286.58"
SAMAERP243541DSQ,SAMASARI TFR+ uthority HEAD OFFICE RIYADH EX Rate : SAR 1.0000000 AMASARI TRF FROM:SAUDI ARABIA 19DEC24 12:52:51,NONREF,Transfer,19/12/2024,"48,800.25",,12:52,19/12/2024,"33,505,440.28"
EPHR98124354RCAH,SAUDI BONYAN TFR+ BANQUE SAUDI FRANSI HEAD OFFICE RIYADH EX Rate : SAR 1.0000000 SA5655000000098811600227 TRF FROM:SAUDI ARABIA 6642 12311,NONREF,Transfer,19/12/2024,"82,110.00",,12:47,19/12/2024,"33,456,640.03"
EPHR98124354R9DH,DIRECT FINANCIAL NETWORK COMPANY TFR+ BANQUE SAUDI FRANSI HEAD OFFICE RIYADH EX Rate : SAR 1.0000000 SA5655000000064493500165 TRF FROM:SAUDI ARABIA 8540 12622,NONREF,Transfer,19/12/2024,"381,312.00",,12:47,19/12/2024,"33,374,530.03"
1604FT24354XVPL4,DR ABDULAZIZ ALAJAJI POLYCLINIC CO DR ABDULAZIZ ALAJAJI POL 23173424514065500 TFR+ SETTLEMENT OF BILL ALINMA BANK ALINMA BANK EX Rate : SAR 1.0000000,NONREF,Transfer,19/12/2024,"40,710.00",,12:46,19/12/2024,"32,993,218.03"
YRTI-16141,LP IPSP2400LKXF4 MOHD Y NAGHI MOTR(R) SA8990000000020000004535 Gulf International Bank RIYADH 20241219SAGULFGULF2BTMS10912392757 19DEC24 12:12:55,NONREF,Transfer,19/12/2024,"9,749.03",,12:12,19/12/2024,"32,952,508.03"
9466835409511FAT,شركة الهرم بلازا المحدوده ركة الهرم بلازا المحدوده أخرى / مصروفات TFR+ دفعه من الحساب RIYAD BANK HEAD OFFICE RIYADH EX Rate : SAR 1.0000000,NONREF,Transfer,19/12/2024,"51,994.95",,12:10,19/12/2024,"32,942,759.00"
387571T01S73,SA SABB 001-754381-004 TFR+,INTER CO 194,Transfer,19/12/2024,"12,500,000.00",,12:08,19/12/2024,"32,890,764.05"
LP CPMN2Y4ZOIRN,"CHARGES SAR 7.00 315571T01G9X ALINMA BANK TOTAL VAT SAR1,05 ON CHARGE AMOUNT SAR7,",609517,Charges,19/12/2024,,-8.05,11:59,19/12/2024,"20,390,764.05"
LP CPMN2Y4ZOIRN,MOHAMMED AWAD ALSAADI TRADING EST 315571T01G9X /RFB/ITC INVOICE PAYMENT ALINMA BANK ALINMA BANK EX Rate : SAR 1.0000000 ALINMA BANK TRF TO:SAUDI ARABIA,609517,Transfer,19/12/2024,,"-10,063.55",11:59,19/12/2024,"20,390,772.10"
TT CPMN0JKBHIRNN,"CHARGES SAR 130.00 572871T01BHX TOTAL VAT SAR19,5 ON CHARGE AMOUNT SAR130,",609568,Charges,19/12/2024,,-149.5,11:59,19/12/2024,"20,400,835.65"
TT CPMN0JKBHIRNN,KALAAM TELECOM BAHRAIN B.S.C (C) 572871T01BHX EX Rate : SAR 3.7550000 AHLI UNITED BANK BSC TRF TO:BAHRAIN,609568,Transfer,19/12/2024,,"-1,051.40",11:59,19/12/2024,"20,400,985.15"
896771T019N9,METAL WORLD EST RD 001-559574-001,609334,Transfer,19/12/2024,,"-6,221.50",11:59,19/12/2024,"20,402,036.55"
LP CPMN2Y4ZNIRN,"CHARGES SAR 7.00 117571T010DU ALINMA BANK TOTAL VAT SAR1,05 ON CHARGE AMOUNT SAR7,",609533,Charges,19/12/2024,,-8.05,11:59,19/12/2024,"20,408,258.05"
LP CPMN2Y4ZNIRN,MADLEN LE TAHSEL ALDYON OFFICE 117571T010DU ALINMA BANK ALINMA BANK EX Rate : SAR 1.0000000 ALINMA BANK TRF TO:SAUDI ARABIA,609533,Transfer,19/12/2024,,"-20,564.13",11:59,19/12/2024,"20,408,266.10"
LP CPMN2Y4ZMIRN,"CHARGES SAR 7.00 498171T01EEY HEAD OFFICE RIYADH TOTAL VAT SAR1,05 ON CHARGE AMOUNT SAR7,",609523,Charges,19/12/2024,,-8.05,11:59,19/12/2024,"20,428,830.23"
LP CPMN2Y4ZMIRN,COMPANI SAMA 498171T01EEY RIYAD BANK HEAD OFFICE RIYADH EX Rate : SAR 1.0000000 RIYAD BANK TRF TO:SAUDI ARABIA,609523,Transfer,19/12/2024,,"-25,300.00",11:59,19/12/2024,"20,428,838.28"
LP CPMN2Y4ZLIRN,"CHARGES SAR 7.00 678971T015SH THE NATIONAL COMMERCIAL BANK TOTAL VAT SAR1,05 ON CHARGE AMOUNT SAR7,",609486,Charges,19/12/2024,,-8.05,11:59,19/12/2024,"20,454,138.28"
LP CPMN2Y4ZLIRN,EASTERN CATERING AND OPERATIONS CO 678971T015SH /RFB/ITC INVOICE PAYMENT NATIONAL COMMERCIAL BANK THE NATIONAL COMMERCIAL BANK EX Rate : SAR 1.0000000 NATIONAL COMMERCIAL BANK,609486,Transfer,19/12/2024,,"-34,799.00",11:59,19/12/2024,"20,454,146.33"
LP CPMN2Y4ZKIRN,"CHARGES SAR 7.00 046471T0116L RIYADH TOTAL VAT SAR1,05 ON CHARGE AMOUNT SAR7,",609683,Charges,19/12/2024,,-8.05,11:59,19/12/2024,"20,488,945.33"
LP CPMN2Y4ZKIRN,CO KHADAMAT ALHULUL ALMUTAQADDIMAH 046471T0116L SAUDI INVESTMENT BANK RIYADH EX Rate : SAR 1.0000000 SAUDI INVESTMENT BANK TRF TO:SAUDI ARABIA,609683,Transfer,19/12/2024,,"-3,000,000.00",11:59,19/12/2024,"20,488,953.38"
LP CPMN2Y4ZJIRN,"CHARGES SAR 7.00 712071T00ZL5 KING ABDUL AZIZ ST ALHOB AR TOTAL VAT SAR1,05 ON CHARGE AMOUNT SAR7,",609598,Charges,19/12/2024,,-8.05,11:59,19/12/2024,"23,488,953.38"
LP CPMN2Y4ZJIRN,HUAWEI TECH. INVESTMENT SAUDI ARABI 712071T00ZL5 /RFB/ITC INVOICE PAYMENT ARAB NATIONAL BANK KING ABDUL AZIZ ST ALHOB AR EX Rate : SAR 1.0000000 ARAB NATIONAL BANK,609598,Transfer,19/12/2024,,"-5,000,000.00",11:59,19/12/2024,"23,488,961.43"
LP CPMN2Y4ZIIRN,"CHARGES SAR 7.00 431071T010EU KING ABDUL AZIZ ST ALHOB AR TOTAL VAT SAR1,05 ON CHARGE AMOUNT SAR7,",609600,Charges,19/12/2024,,-8.05,11:59,19/12/2024,"28,488,961.43"
LP CPMN2Y4ZIIRN,HUAWEI TECH. INVESTMENT SAUDI ARABI 431071T010EU /RFB/ITC INVOICE PAYMENT ARAB NATIONAL BANK KING ABDUL AZIZ ST ALHOB AR EX Rate : SAR 1.0000000 ARAB NATIONAL BANK,609600,Transfer,19/12/2024,,"-5,000,000.00",11:59,19/12/2024,"28,488,969.48"
EBIL981243544YGB,HILTON GARDEN INN AL KHOBAR HOTEL HILTON GARDEN INN AL KHO ITC Q3 2024 TFR+ EMIRATES NBD BANK PJSC EMIRATES BANK INTERNATIO NAL EX Rate : SAR 1.0000000,NONREF,Transfer,19/12/2024,"69,624.45",,11:20,19/12/2024,"33,488,969.48"
FT24354156544911,ITC SETTLEMENT OF BILLS TFR+ BANK AL BILAD BANK AL BILAD EX Rate : SAR 1.0000000 SA2715000555111844440008 TRF FROM:SAUDI ARABIA RIYADH-Saudi Arabia,NONREF,Transfer,19/12/2024,"3,000,000.00",,11:13,19/12/2024,"33,419,345.03"
FT24354032903594,ITC SETTLEMENT OF BILLS TFR+ BANK AL BILAD BANK AL BILAD EX Rate : SAR 1.0000000 SA2715000555111844440008 TRF FROM:SAUDI ARABIA RIYADH-Saudi Arabia,NONREF,Transfer,19/12/2024,"2,000,000.00",,11:13,19/12/2024,"30,419,345.03"
FT24354117019742,ITC SETTLEMENT OF BILLS TFR+ BANK AL BILAD BANK AL BILAD EX Rate : SAR 1.0000000 SA2715000555111844440008 TRF FROM:SAUDI ARABIA RIYADH-Saudi Arabia,NONREF,Transfer,19/12/2024,"3,000,000.00",,11:13,19/12/2024,"28,419,345.03"
FT24354141437400,ITC SETTLEMENT OF BILLS TFR+ BANK AL BILAD BANK AL BILAD EX Rate : SAR 1.0000000 SA2715000555111844440008 TRF FROM:SAUDI ARABIA RIYADH-Saudi Arabia,NONREF,Transfer,19/12/2024,"3,000,000.00",,11:13,19/12/2024,"25,419,345.03"
FT24354141443636,ITC SETTLEMENT OF BILLS TFR+ BANK AL BILAD BANK AL BILAD EX Rate : SAR 1.0000000 SA2715000555111844440008 TRF FROM:SAUDI ARABIA RIYADH-Saudi Arabia,NONREF,Transfer,19/12/2024,"3,000,000.00",,11:13,19/12/2024,"22,419,345.03"
FT24354912869232,ITC SETTLEMENT OF BILLS TFR+ BANK AL BILAD BANK AL BILAD EX Rate : SAR 1.0000000 SA2715000555111844440008 TRF FROM:SAUDI ARABIA RIYADH-Saudi Arabia,NONREF,Transfer,19/12/2024,"3,000,000.00",,11:13,19/12/2024,"19,419,345.03"
5.00003E+11,LADUN INVESTMENT COMPANY INTB0172535195040034008E TFR+ AL RAJHI BANKING AND INV T CORP HEAD OFFICE RIYADH EX Rate : SAR 1.0000000 SA4480000504608010034008 TRF FROM:SAUDI ARABIA,NONREF,Transfer,19/12/2024,"47,955.00",,10:09,19/12/2024,"16,419,345.03"
TT RPLN0JJ1MIRN,"CHARGES SAR 130.00 036771T01MAK TOTAL VAT SAR19,5 ON CHARGE AMOUNT SAR130,",609621,Charges,19/12/2024,,-149.5,6:00,19/12/2024,"16,371,390.03"
TT RPLN0JJ1MIRN,"INTRALINKS, INC. 036771T01MAK DEAL ID. 5220547 EX Rate : SAR 3.7550000 JPMORGAN CHASE BANK NA TRF TO:UNITED STATES",609621,Transfer,19/12/2024,,"-345,147.10",6:00,19/12/2024,"16,371,539.53"
LP CPMN2Y025IRN,"CHARGES SAR 7.00 121771T013ZZ EMIRATES BANK INTERNATIO NAL TOTAL VAT SAR1,05 ON CHARGE AMOUNT SAR7,",609616,Charges,19/12/2024,,-8.05,1:09,19/12/2024,"16,716,686.63"
LP CPMN2Y025IRN,PRICEWATERHOUSECOOPERS PUBLIC 121771T013ZZ EMIRATES NBD BANK PJSC EMIRATES BANK INTERNATIO NAL EX Rate : SAR 1.0000000 EMIRATES NBD BANK PJSC TRF TO:SAUDI ARABIA,609616,Transfer,19/12/2024,,"-831,450.00",1:09,19/12/2024,"16,716,694.68"
BTBW-00033,FROM AL ELM INFORMATION BTB- BTBW00033241218 ADVANCE PAYMENT,2024026001,Transfer,19/12/2024,"241,855.35",,0:00,19/12/2024,"17,548,144.68"
Factory of Baker,INV240931254593 11956013 903 TFR+,2014604374,Transfer,19/12/2024,"109,122.94",,22:28,19/12/2024,"17,306,289.33"
BTPR-00423,20241218194248 2294970831BLR:090SVR:003 SADAD:5668399423,LIST 110,Transfer,18/12/2024,,-325,19:42,18/12/2024,"17,197,166.39"
BTPQ-00423,20241218194247 2409493232BLR:090SVR:003 SADAD:5668399412,LIST 110,Transfer,18/12/2024,,-650,19:42,18/12/2024,"17,197,491.39"
BTPP-00422,20241218194246 2282078332BLR:090SVR:003 SADAD:5668399401,LIST 110,Transfer,18/12/2024,,-325,19:42,18/12/2024,"17,198,141.39"
BTPO-00422,20241218194245 2041942984BLR:090SVR:003 SADAD:5668400234,LIST 110,Transfer,18/12/2024,,-325,19:42,18/12/2024,"17,198,466.39"
BTPN-00421,20241218194244 2164876910BLR:090SVR:003 SADAD:5668400220,LIST 110,Transfer,18/12/2024,,-325,19:42,18/12/2024,"17,198,791.39"
BTPP-00419,20241218193833 2260763483BLR:090SVR:003 SADAD:5668395572,LIST 110,Transfer,18/12/2024,,-325,19:38,18/12/2024,"17,199,116.39"
BTPO-00419,20241218193833 2341506653BLR:090SVR:003 SADAD:5668394527,LIST 110,Transfer,18/12/2024,,-650,19:38,18/12/2024,"17,199,441.39"
BTPN-00418,20241218193831 2027476700BLR:090SVR:003 SADAD:5668394514,list 110,Transfer,18/12/2024,,-325,19:38,18/12/2024,"17,200,091.39"
BTPM-00420,20241218193830 2461152361BLR:090SVR:003 SADAD:5668394499,list 107,Transfer,18/12/2024,,-650,19:38,18/12/2024,"17,200,416.39"
BTPL-00416,20241218193829 2216884300BLR:090SVR:003 SADAD:5668395523,list 107,Transfer,18/12/2024,,-650,19:38,18/12/2024,"17,201,066.39"
BTPK-00420,20241218193828 2408069868BLR:090SVR:003 SADAD:5668395509,LIST 110,Transfer,18/12/2024,,-650,19:38,18/12/2024,"17,201,716.39"
BTPJ-00417,20241218193827 2532200645BLR:090SVR:003 SADAD:5668395497,LIST 110,Transfer,18/12/2024,,-325,19:38,18/12/2024,"17,202,366.39"
BTPI-00418,20241218193826 2525152498BLR:090SVR:003 SADAD:5668395487,LIST 110,Transfer,18/12/2024,,-325,19:38,18/12/2024,"17,202,691.39"
BTPH-00419,20241218193825 2412008357BLR:090SVR:003 SADAD:5668394426,LIST 110,Transfer,18/12/2024,,-325,19:38,18/12/2024,"17,203,016.39"
BTPG-00419,20241218193824 2355322724BLR:090SVR:003 SADAD:5668395475,LIST 110,Transfer,18/12/2024,,-325,19:38,18/12/2024,"17,203,341.39"
BTPF-00420,20241218193823 2295676627BLR:090SVR:003 SADAD:5668395457,LIST 110,Transfer,18/12/2024,,-325,19:38,18/12/2024,"17,203,666.39"
BTPE-00418,20241218193822 2287218305BLR:090SVR:003 SADAD:5668395443,LIST 110,Transfer,18/12/2024,,-325,19:38,18/12/2024,"17,203,991.39"
BTPD-00420,20241218193821 2130824333BLR:090SVR:003 SADAD:5668394389,LIST 110,Transfer,18/12/2024,,-575,19:38,18/12/2024,"17,204,316.39"
BTPC-00416,20241218193817 2121328419BLR:090SVR:003 SADAD:5668393389,LIST 110,Transfer,18/12/2024,,-325,19:38,18/12/2024,"17,204,891.39"
BTPB-00415,20241218193816 2081990935BLR:090SVR:003 SADAD:5668393382,LIST 110,Transfer,18/12/2024,,-325,19:38,18/12/2024,"17,205,216.39"
BTPA-00419,20241218193815 2470590874BLR:090SVR:003 SADAD:5668394317,LIST 110,Transfer,18/12/2024,,-162,19:38,18/12/2024,"17,205,541.39"
BTPZ-00420,20241218193814 2481504161BLR:090SVR:003 SADAD:5668393358,LIST 110,Transfer,18/12/2024,,-650,19:38,18/12/2024,"17,205,703.39"
BTPY-00419,20241218193813 2430233045BLR:090SVR:003 SADAD:5668394299,LIST 110,Transfer,18/12/2024,,-650,19:38,18/12/2024,"17,206,353.39"
BTPX-00419,20241218193812 2360787945BLR:090SVR:003 SADAD:5668394284,LIST 110,Transfer,18/12/2024,,-650,19:38,18/12/2024,"17,207,003.39"
BTPW-00418,20241218193811 2360742908BLR:090SVR:003 SADAD:5668394276,LIST 110,Transfer,18/12/2024,,-650,19:38,18/12/2024,"17,207,653.39"
BTPV-00415,20241218193810 2320751569BLR:090SVR:003 SADAD:5668393311,LIST 110,Transfer,18/12/2024,,-650,19:38,18/12/2024,"17,208,303.39"
BTPU-00420,20241218193808 2304416403BLR:090SVR:003 SADAD:5668394257,LIST 110,Transfer,18/12/2024,,-650,19:38,18/12/2024,"17,208,953.39"
BTPT-00419,20241218193807 2262812619BLR:090SVR:003 SADAD:5668394246,LIST 110,Transfer,18/12/2024,,"-1,150.00",19:38,18/12/2024,"17,209,603.39"
BTPS-00419,20241218193806 2253129320BLR:090SVR:003 SADAD:5668393259,LIST 110,Transfer,18/12/2024,,-650,19:38,18/12/2024,"17,210,753.39"
BTPR-00419,20241218193805 2173575750BLR:090SVR:003 SADAD:5668394222,LIST 110,Transfer,18/12/2024,,-650,19:38,18/12/2024,"17,211,403.39"
BTPQ-00419,20241218193804 2120885278BLR:090SVR:003 SADAD:5668393241,LIST 110,Transfer,18/12/2024,,-650,19:38,18/12/2024,"17,212,053.39"
BTPP-00418,20241218193803 2032002749BLR:090SVR:003 SADAD:5668394197,LIST 110,Transfer,18/12/2024,,-650,19:38,18/12/2024,"17,212,703.39"
BTPO-00418,20241218193802 2154246520BLR:090SVR:003 SADAD:5668394182,LIST 110,Transfer,18/12/2024,,-650,19:38,18/12/2024,"17,213,353.39"
BTPN-00417,20241218193800 2566014565BLR:090SVR:003 SADAD:5668394170,LIST 110,Transfer,18/12/2024,,-650,19:38,18/12/2024,"17,214,003.39"
BTPM-00419,20241218193759 2493861021BLR:090SVR:003 SADAD:5668393192,LIST 110,Transfer,18/12/2024,,-650,19:38,18/12/2024,"17,214,653.39"
BTPL-00415,20241218193758 2361046077BLR:090SVR:003 SADAD:5668393185,LIST 110,Transfer,18/12/2024,,-650,19:37,18/12/2024,"17,215,303.39"
BTPK-00419,20241218193757 2503970093BLR:090SVR:003 SADAD:5668394150,LIST 110,Transfer,18/12/2024,,-650,19:37,18/12/2024,"17,215,953.39"
BTPJ-00416,20241218193756 2565216914BLR:090SVR:003 SADAD:5668394138,LIST 110,Transfer,18/12/2024,,-650,19:37,18/12/2024,"17,216,603.39"
BTPI-00417,20241218193755 2344928862BLR:090SVR:003 SADAD:5668393140,LIST 110,Transfer,18/12/2024,,-650,19:37,18/12/2024,"17,217,253.39"
BTPH-00418,20241218193754 2323212460BLR:090SVR:003 SADAD:5668393132,LIST 110,Transfer,18/12/2024,,-650,19:37,18/12/2024,"17,217,903.39"
BTPG-00418,20241218193753 2096301433BLR:090SVR:003 SADAD:5668394107,LIST 110,Transfer,18/12/2024,,"-1,150.00",19:37,18/12/2024,"17,218,553.39"
BTPF-00419,20241218193752 2131597805BLR:090SVR:003 SADAD:5668393109,LIST 110,Transfer,18/12/2024,,"-1,150.00",19:37,18/12/2024,"17,219,703.39"
BTPE-00417,20241218193751 2121009522BLR:090SVR:003 SADAD:5668394090,LIST 110,Transfer,18/12/2024,,-288,19:37,18/12/2024,"17,220,853.39"
BTPD-00419,20241218193750 2226612030BLR:090SVR:003 SADAD:5668393092,LIST 110,Transfer,18/12/2024,,-650,19:37,18/12/2024,"17,221,141.39"
BTPC-00415,20241218193745 2415292362BLR:090SVR:003 SADAD:5668393040,LIST 110,Transfer,18/12/2024,,-650,19:37,18/12/2024,"17,221,791.39"
BTPB-00414,20241218193744 2562027280BLR:090SVR:003 SADAD:5668394014,LIST 110,Transfer,18/12/2024,,-650,19:37,18/12/2024,"17,222,441.39"
YRTI-33008,LP IPSP2400LJKMM ALSOUKYA INTERNATIONAL C SA5655000000085805100117 Banque Saudi Fransi RIYADH 20241218SABSFRBSFR6BCFT11902102755 18DEC24 19:02:52,NONREF,Transfer,18/12/2024,"17,139.60",,19:02,18/12/2024,"17,223,091.39"
164071M00M2B,AL-KAM TELECOMMUNICATION TFR+ INV0038225-227-233-234-235-236 INV-240731193426-INV-0041514 INV241031193426-INV-0044165,1-SALAM,Transfer,18/12/2024,"49,705.37",,18:12,18/12/2024,"17,205,951.79"
6.66393E+15,L+T HYDROCARBON SAUDI TFR+ 8600-4860146488-2024,860022541S227459,Transfer,18/12/2024,"95,969.34",,17:08,18/12/2024,"17,156,246.42"
9006A1U99UBT,ALFA LAVAL ALARABIA FOR TFR+,INV.PAY,Transfer,18/12/2024,"23,908.50",,16:06,18/12/2024,"17,060,277.08"
YRTI-24620,LP IPSP2400LJ3F3 LIME AND SANDLIME SA2220000003210125699901 Riyad Bank RIYADH 20241218SARIBLRIBL6BTMS11553151301 18DEC24 15:53:43,NONREF,Transfer,18/12/2024,"19,906.50",,15:53,18/12/2024,"17,036,368.58"
52850FIN181224,FINANCE DIVISION INV NO CINV240921268891 TFR+ INV DT 29/09/2024:11/12/2024 CN240921268889:8 INVOICES BANK AL-JAZIRA HEAD OFFICE JEDDAH EX Rate : SAR 1.0000000 0800833051682,NONREF,Transfer,18/12/2024,"650,392.46",,15:35,18/12/2024,"17,016,462.08"
EPHR98124353Q4TX,EIRAD FOR TRADING CONTRACTING CO EIRAD FOR TRADING CONTRA ITC JUL TO SEP 2024 ITC TFR+ 2024 BANQUE SAUDI FRANSI HEAD OFFICE RIYADH EX Rate : SAR 1.0000000,NONREF,Transfer,18/12/2024,"20,010.00",,15:33,18/12/2024,"16,366,069.62"
1604FT24353W7RHH,DANAH ALJUBAIL SUITES TFR+ 2024 ر الي ديسمبر SETTLEMENT OF BILL ALINMA BANK ALINMA BANK EX Rate : SAR 1.0000000 SA6005000068202127433001,NONREF,Transfer,18/12/2024,"52,785.00",,15:08,18/12/2024,"16,346,059.62"
547571T01KR4,HELLMANN SAUDI ARABIA TFR+,INV241221264976,Transfer,18/12/2024,"7,101.25",,15:07,18/12/2024,"16,293,274.62"
737571T01WKX,HELLMANN SAUDI ARABIA TFR+,2 INVS,Transfer,18/12/2024,"13,144.50",,15:07,18/12/2024,"16,286,173.37"
NCBK82424353ASDL,AL-BARRAK EDUCATIONA Operating Expenses TFR+ Service/Utility Bills INV241231288592 Dec 2024 NATIONAL COMMERCIAL BANK NATIONAL COMMERCIAL BANK EX Rate : SAR 1.0000000,NONREF,Transfer,18/12/2024,"32,085.00",,14:16,18/12/2024,"16,273,028.87"
192171T010NR,BINSALEM SAMAR 072-124415-001 /RFB/ITC CWF PAYMENT,609585,Transfer,18/12/2024,,"-20,277.20",14:09,18/12/2024,"16,240,943.87"
746171T010PY,BINSALEM SAMAR 072-124415-001 /RFB/ITC CWF PAYMENT,609586,Transfer,18/12/2024,,"-24,028.58",14:09,18/12/2024,"16,261,221.07"
LP CPMN2XXUAIRN,"CHARGES SAR 7.00 518371T01A0I CORP OPS DIV RIYADH TOTAL VAT SAR1,05 ON CHARGE AMOUNT SAR7,",MANUAL - 4359798,Charges,18/12/2024,,-8.05,14:08,18/12/2024,"16,285,249.65"
LP CPMN2XXUAIRN,AHMED MOHAMMED A ALANGARI 518371T01A0I BANQUE SAUDI FRANSI CORP OPS DIV RIYADH EX Rate : SAR 1.0000000 BANQUE SAUDI FRANSI TRF TO:SAUDI ARABIA,MANUAL - 4359798,Transfer,18/12/2024,,"-19,059.00",14:08,18/12/2024,"16,285,257.70"
94668353095119XH,شركة مكديرمت العربيه المحدوده مكديرمت العربيه المحدوده expenses/Other TFR+ INTEGRATED TELECOM COMPANY RIYAD BANK HEAD OFFICE RIYADH EX Rate : SAR 1.0000000,NONREF,Transfer,18/12/2024,"24,514.73",,14:08,18/12/2024,"16,304,316.70"
1604FT2435386S2D,ركة الشرق الاوسط للرعاية الصحيه ال الاوسط للرعاية الصحيه ال 23173451310527100 INVOIC TFR+ SETTLEMENT OF BILL ALINMA BANK ALINMA BANK EX Rate : SAR 1.0000000,NONREF,Transfer,18/12/2024,"35,650.00",,14:01,18/12/2024,"16,279,801.97"
BTPB-00173,13460601798137 050 13460601798137 SADAD:5667880097,LIST 110,Transfer,18/12/2024,,"-4,250.00",13:59,18/12/2024,"16,244,151.97"
BTPA-00174,17460601798195 050 17460601798195 SADAD:5667880083,LIST 110,Transfer,18/12/2024,,"-8,500.00",13:59,18/12/2024,"16,248,401.97"
BTPZ-00175,19460601798449 050 19460601798449 SADAD:5667880073,LIST 110,Transfer,18/12/2024,,"-8,500.00",13:59,18/12/2024,"16,256,901.97"
BTPW-00174,17460601798393 050 17460601798393 SADAD:5667880040,LIST 110,Transfer,18/12/2024,,"-8,500.00",13:59,18/12/2024,"16,265,401.97"
BTPV-00170,17460601798564 050 17460601798564 SADAD:5667880026,LIST 110,Transfer,18/12/2024,,"-8,500.00",13:59,18/12/2024,"16,273,901.97"
BTPU-00174,10460601896973 050 10460601896973 SADAD:5667878419,LIST 110,Transfer,18/12/2024,,-100,13:59,18/12/2024,"16,282,401.97"
BTPT-00174,14460601798507 050 14460601798507 SADAD:5667879993,LIST 110,Transfer,18/12/2024,,"-8,500.00",13:59,18/12/2024,"16,282,501.97"
BTPS-00173,11460609798885 050 11460609798885 SADAD:5667879973,LIST 110,Transfer,18/12/2024,,"-2,125.00",13:59,18/12/2024,"16,291,001.97"
BTPR-00173,14460601895545 050 14460601895545 SADAD:5667879954,LIST 110,Transfer,18/12/2024,,"-8,500.00",13:59,18/12/2024,"16,293,126.97"
BTPP-00172,17460601811117 050 17460601811117 SADAD:5667879946,LIST 110,Transfer,18/12/2024,,"-8,500.00",13:59,18/12/2024,"16,301,626.97"
BTPO-00174,17460601799031 050 17460601799031 SADAD:5667878366,LIST 110,Transfer,18/12/2024,,"-4,250.00",13:59,18/12/2024,"16,310,126.97"
BTPM-00173,15460604799108 050 15460604799108 SADAD:5667879912,LIST 110,Transfer,18/12/2024,,"-4,250.00",13:59,18/12/2024,"16,314,376.97"
BTPL-00170,14460609798923 050 14460609798923 SADAD:5667878343,LIST 110,Transfer,18/12/2024,,"-4,250.00",13:59,18/12/2024,"16,318,626.97"
BTPK-00173,14460601798084 050 14460601798084 SADAD:5667879876,LIST 110,Transfer,18/12/2024,,"-4,250.00",13:59,18/12/2024,"16,322,876.97"
BTPI-00170,00136382122432 368 00136382122432 SADAD:5667873682,list 110,Transfer,18/12/2024,,"-2,875.00",13:55,18/12/2024,"16,327,126.97"
BTPS-00169,14460601855828 050 14460601855828 SADAD:5667871005,LIST 110,Transfer,18/12/2024,,"-4,850.00",13:54,18/12/2024,"16,330,001.97"
BTPR-00169,10460601862385 050 10460601862385 SADAD:5667870986,LIST 110,Transfer,18/12/2024,,"-9,700.00",13:54,18/12/2024,"16,334,851.97"
BTPQ-00170,12460601798686 050 12460601798686 SADAD:5667872592,LIST 110,Transfer,18/12/2024,,"-4,250.00",13:54,18/12/2024,"16,344,551.97"
BTPL-00166,18460601868396 050 18460601868396 SADAD:5667870915,LIST 110,Transfer,18/12/2024,,"-9,700.00",13:54,18/12/2024,"16,348,801.97"
BTPK-00169,15460601028278 050 15460601028278 SADAD:5667872522,LIST 110,Transfer,18/12/2024,,"-2,425.00",13:54,18/12/2024,"16,358,501.97"
BTPJ-00166,18460601860880 050 18460601860880 SADAD:5667870888,LIST 110,Transfer,18/12/2024,,"-9,700.00",13:54,18/12/2024,"16,360,926.97"
BTPI-00168,19460601860999 050 19460601860999 SADAD:5667872502,LIST 110,Transfer,18/12/2024,,"-9,700.00",13:54,18/12/2024,"16,370,626.97"
BTPH-00168,13460601861190 050 13460601861190 SADAD:5667870865,LIST 110,Transfer,18/12/2024,,"-9,700.00",13:54,18/12/2024,"16,380,326.97"
BTPG-00168,18460601861302 050 18460601861302 SADAD:5667872490,LIST 110,Transfer,18/12/2024,,"-9,700.00",13:54,18/12/2024,"16,390,026.97"
BTPF-00170,18460601861401 050 18460601861401 SADAD:5667870846,LIST 110,Transfer,18/12/2024,,"-9,700.00",13:54,18/12/2024,"16,399,726.97"
BTPE-00168,11460601861648 050 11460601861648 SADAD:5667872464,LIST 110,Transfer,18/12/2024,,"-9,700.00",13:54,18/12/2024,"16,409,426.97"
BTPD-00169,19460601861754 050 19460601861754 SADAD:5667870813,LIST 110,Transfer,18/12/2024,,"-9,700.00",13:54,18/12/2024,"16,419,126.97"
BTPC-00169,15460601861967 050 15460601861967 SADAD:5667870804,LIST 110,Transfer,18/12/2024,,"-9,700.00",13:54,18/12/2024,"16,428,826.97"
BTPB-00168,14460601862226 050 14460601862226 SADAD:5667872422,LIST 110,Transfer,18/12/2024,,"-9,700.00",13:54,18/12/2024,"16,438,526.97"
BTPA-00169,15460601867646 050 15460601867646 SADAD:5667870780,LIST 110,Transfer,18/12/2024,,"-9,700.00",13:54,18/12/2024,"16,448,226.97"
BTPZ-00170,12460601868048 050 12460601868048 SADAD:5667872393,LIST 110,Transfer,18/12/2024,,"-9,700.00",13:54,18/12/2024,"16,457,926.97"
BTPY-00170,13460601868823 050 13460601868823 SADAD:5667870760,LIST 110,Transfer,18/12/2024,,"-9,700.00",13:54,18/12/2024,"16,467,626.97"
BTPX-00170,11460601859380 050 11460601859380 SADAD:5667872360,LIST 110,Transfer,18/12/2024,,"-7,275.00",13:54,18/12/2024,"16,477,326.97"
BTPW-00169,19460601862078 050 19460601862078 SADAD:5667872305,LIST 110,Transfer,18/12/2024,,"-9,700.00",13:54,18/12/2024,"16,484,601.97"
BTPV-00165,11460601859173 050 11460601859173 SADAD:5667870673,LIST 110,Transfer,18/12/2024,,"-4,850.00",13:54,18/12/2024,"16,494,301.97"
BTPU-00169,12460601858995 050 12460601858995 SADAD:5667872270,LIST 110,Transfer,18/12/2024,,"-4,850.00",13:54,18/12/2024,"16,499,151.97"
BTPT-00169,11460601858859 050 11460601858859 SADAD:5667870641,LIST 110,Transfer,18/12/2024,,"-4,850.00",13:54,18/12/2024,"16,504,001.97"
BTPS-00168,15460601858655 050 15460601858655 SADAD:5667872245,LIST 110,Transfer,18/12/2024,,"-4,850.00",13:54,18/12/2024,"16,508,851.97"
BTPR-00168,18460601856957 050 18460601856957 SADAD:5667872225,LIST 110,Transfer,18/12/2024,,"-4,850.00",13:54,18/12/2024,"16,513,701.97"
BTPQ-00169,11460601856671 050 11460601856671 SADAD:5667870592,LIST 110,Transfer,18/12/2024,,"-4,850.00",13:54,18/12/2024,"16,518,551.97"
BTPP-00167,15460601856477 050 15460601856477 SADAD:5667872209,LIST 110,Transfer,18/12/2024,,"-4,850.00",13:54,18/12/2024,"16,523,401.97"
BTPN-00168,15460601856279 050 15460601856279 SADAD:5667870565,LIST 110,Transfer,18/12/2024,,"-4,850.00",13:54,18/12/2024,"16,528,251.97"
BTPM-00168,13460601861857 050 13460601861857 SADAD:5667870552,LIST 110,Transfer,18/12/2024,,"-9,700.00",13:54,18/12/2024,"16,533,101.97"
BTPK-00168,11460601856068 050 11460601856068 SADAD:5667872170,LIST 110,Transfer,18/12/2024,,"-4,850.00",13:54,18/12/2024,"16,542,801.97"
BTPJ-00165,18460601855561 050 18460601855561 SADAD:5667872162,LIST 110,Transfer,18/12/2024,,"-4,850.00",13:54,18/12/2024,"16,547,651.97"
BTPI-00167,14460601868266 050 14460601868266 SADAD:5667872151,LIST 110,Transfer,18/12/2024,,"-9,700.00",13:54,18/12/2024,"16,552,501.97"
BTPH-00167,13460601811159 050 13460601811159 SADAD:5667870492,LIST 110,Transfer,18/12/2024,,"-8,500.00",13:54,18/12/2024,"16,562,201.97"
BTPG-00167,10460601811147 050 10460601811147 SADAD:5667872132,LIST 110,Transfer,18/12/2024,,"-8,500.00",13:54,18/12/2024,"16,570,701.97"
BTPF-00169,16460601811134 050 16460601811134 SADAD:5667870463,LIST 110,Transfer,18/12/2024,,"-8,500.00",13:54,18/12/2024,"16,579,201.97"
BTPE-00167,15460601798968 050 15460601798968 SADAD:5667870449,LIST 110,Transfer,18/12/2024,,"-8,500.00",13:54,18/12/2024,"16,587,701.97"
BTPD-00168,10460601798611 050 10460601798611 SADAD:5667870432,LIST 110,Transfer,18/12/2024,,"-8,500.00",13:54,18/12/2024,"16,596,201.97"
BTPC-00168,14460604799143 050 14460604799143 SADAD:5667872090,LIST 110,Transfer,18/12/2024,,"-8,500.00",13:54,18/12/2024,"16,604,701.97"
BTPB-00167,13460601798353 050 13460601798353 SADAD:5667872080,LIST 110,Transfer,18/12/2024,,"-8,500.00",13:54,18/12/2024,"16,613,201.97"
BTPY-00169,062273672749576 085 062273672749576 SADAD:5667870376,list 110,Transfer,18/12/2024,,"-18,400.00",13:54,18/12/2024,"16,621,701.97"
LP CPMN2XXPSIRN,"CHARGES SAR 7.00 230371R00LLP KING ABDUL AZIZ ST ALHOB AR TOTAL VAT SAR1,05 ON CHARGE AMOUNT SAR7,",MANUAL 4359767,Charges,18/12/2024,,-8.05,13:51,18/12/2024,"16,640,101.97"
LP CPMN2XXPSIRN,مكتب سفر حنش العمري للترجمه 230371R00LLP ARAB NATIONAL BANK KING ABDUL AZIZ ST ALHOB AR EX Rate : SAR 1.0000000 ARAB NATIONAL BANK TRF TO:SAUDI ARABIA,MANUAL 4359767,Transfer,18/12/2024,,"-2,310.00",13:51,18/12/2024,"16,640,110.02"
653371R00DXF,SABTI SULTAN 355-154113-001,FIN SETT 4359755,Transfer,18/12/2024,,"-20,639.00",13:50,18/12/2024,"16,642,420.02"
109571R00AZM,ALHARBI IBRAHIM 162-246383-001,FIN SETT 4359754,Transfer,18/12/2024,,"-41,470.00",13:50,18/12/2024,"16,663,059.02"
ECOF41218H000467,SICIM SAUDI ARABIA CO Operational Expenses TFR+ MULTIPLE INVS BANK AL-JAZIRA HEAD OFFICE JEDDAH EX Rate : SAR 1.0000000 SA5560100020895004427001 TRF FROM:SAUDI ARABIA,NONREF,Transfer,18/12/2024,"413,661.78",,13:40,18/12/2024,"16,704,529.02"
NCBK6592435306YW,لشركة السعودية لمعدات الديزل المح TFR+ كامل قيمة بضاعه جاهزة NATIONAL COMMERCIAL BANK NATIONAL COMMERCIAL BANK EX Rate : SAR 1.0000000 05512840040110 TRF FROM:SAUDI ARABIA,NONREF,Transfer,18/12/2024,"60,599.25",,13:05,18/12/2024,"16,290,867.24"
9.17721E+15,MARSH ARABIA INSURANCE TFR+,9.66002E+11,Transfer,18/12/2024,"39,823.35",,11:53,18/12/2024,"16,230,267.99"
8.93911E+15,MARSH ARABIA INSURANCE TFR+,9.66002E+11,Transfer,18/12/2024,"3,001.50",,11:53,18/12/2024,"16,190,444.64"
7.7071E+15,MARSH ARABIA INSURANCE TFR+,9.66002E+11,Transfer,18/12/2024,"4,105.50",,11:53,18/12/2024,"16,187,443.14"
7.70381E+15,MARSH ARABIA INSURANCE TFR+,9.66002E+11,Transfer,18/12/2024,"57,960.00",,11:53,18/12/2024,"16,183,337.64"
7.64591E+15,MARSH ARABIA INSURANCE TFR+,9.66002E+11,Transfer,18/12/2024,"32,602.50",,11:53,18/12/2024,"16,125,377.64"
7.33599E+15,MARSH ARABIA INSURANCE TFR+,9.66002E+11,Transfer,18/12/2024,"57,960.00",,11:53,18/12/2024,"16,092,775.14"
5.57771E+15,MARSH ARABIA INSURANCE TFR+,9.66002E+11,Transfer,18/12/2024,"3,001.50",,11:53,18/12/2024,"16,034,815.14"
4.3398E+15,MARSH ARABIA INSURANCE TFR+,9.66002E+11,Transfer,18/12/2024,"3,001.50",,11:53,18/12/2024,"16,031,813.64"
4.11091E+15,MARSH ARABIA INSURANCE TFR+,9.66002E+11,Transfer,18/12/2024,"3,001.50",,11:53,18/12/2024,"16,028,812.14"
3.199E+15,MARSH ARABIA INSURANCE TFR+,9.66002E+11,Transfer,18/12/2024,"3,001.50",,11:53,18/12/2024,"16,025,810.64"
3.01112E+15,MARSH ARABIA INSURANCE TFR+,9.66002E+11,Transfer,18/12/2024,"32,602.50",,11:53,18/12/2024,"16,022,809.14"
2.6722E+15,MARSH ARABIA INSURANCE TFR+,9.66002E+11,Transfer,18/12/2024,"70,794.00",,11:53,18/12/2024,"15,990,206.64"
1.06451E+15,MARSH ARABIA INSURANCE TFR+,9.66002E+11,Transfer,18/12/2024,"3,001.50",,11:53,18/12/2024,"15,919,412.64"
9003U41Z7NOP,AL MAJAL SERVICE MASTER TFR+ SUPPLIER BALANCE DEC24,202412315-423,Transfer,18/12/2024,"6,175.50",,10:23,18/12/2024,"15,916,411.14"
946683530951181K,ركة رسن لتقنية المعلومات شركة مساه TFR+ INV241011275268 INV241011250843 RIYAD BANK HEAD OFFICE RIYADH EX Rate : SAR 1.0000000 SA8820000002601201339940,NONREF,Transfer,18/12/2024,"91,770.00",,10:21,18/12/2024,"15,910,235.64"
5.00003E+11,CRWON PLAZA HOTEL ALKHOBAR CRWON PLAZA HOTEL ALKHOB INTB0079958225550020021E TFR+ AL RAJHI BANKING AND INV T CORP HEAD OFFICE RIYADH EX Rate : SAR 1.0000000,NONREF,Transfer,18/12/2024,"79,350.00",,10:13,18/12/2024,"15,818,465.64"
V241218095726729,401014602346418 :تنفيذ قضااى 401014602346418 :ذ قضااى /99/16553368 TFR+ AL RAJHI BANKING AND INV T CORP HEAD OFFICE RIYADH EX Rate : SAR 1.0000000,NONREF,Transfer,18/12/2024,"1,500.00",,10:13,18/12/2024,"15,739,115.64"
9002S71WGGZT,GENERAL EXPENSES TFR+,SA033-173-122,Transfer,18/12/2024,"16,560.00",,10:01,18/12/2024,"15,737,615.64"
010141217H785215,JASMINE WATER AND BEVERAGES FACTORY JASMINE WATER AND BEVERA Ms Azure Servers TFR+ SAUDI INVESTMENT BANK RIYADH EX Rate : SAR 1.0000000 0101 136419 001,NONREF,Transfer,18/12/2024,"120,000.00",,9:42,18/12/2024,"15,721,055.64"
5.00003E+11,AL RAJHI CAPITAL COMPANY INTB0058313345040012772E TFR+ AL RAJHI BANKING AND INV T CORP HEAD OFFICE RIYADH EX Rate : SAR 1.0000000 SA4980000504608010012772 TRF FROM:SAUDI ARABIA,NONREF,Transfer,18/12/2024,"42,954.80",,9:41,18/12/2024,"15,601,055.64"
9.46684E+15,ركة الدار العربية للطباعة والنشر ا العربية للطباعة والنشر ا Purchase/expenses/Utilit TFR+ ذهبان الربع الاخير فاتورة RIYAD BANK HEAD OFFICE RIYADH,NONREF,Transfer,18/12/2024,"20,700.00",,9:37,18/12/2024,"15,558,100.84"
679071S01197,NESMA TRADING CO. LTD TFR+ /RFB/100 41617,SB12400457414,Transfer,18/12/2024,"142,916.25",,8:58,18/12/2024,"15,537,400.84"
TT CPMN0JHKXIRNN,"CHARGES SAR 130.00 367771Q00V2V TOTAL VAT SAR19,5 ON CHARGE AMOUNT SAR130,",609607,Charges,18/12/2024,,-149.5,6:00,18/12/2024,"15,394,484.59"
TT CPMN0JHKXIRNN,QSCERT MIDDLE EAST W.L.L 367771Q00V2V /RFB/ITC ADVANCE PAYMENT EX Rate : SAR .9996200 BBK TRF TO:BAHRAIN,609607,Transfer,18/12/2024,,"-31,338.09",6:00,18/12/2024,"15,394,634.09"
195071S019MN,KHALIFA ALGOSAIBI COMPAN TFR+,INV00139401,Transfer,17/12/2024,"66,120.00",,16:36,17/12/2024,"15,425,972.18"
POBE-00030,DEPOSIT COMMISSION 001-754381-206 TMD TERM DEPOSIT,NONREF,Transfer,12/12/2024,,"-25,000,000.00",16:33,17/12/2024,"15,359,852.18"
YRTI-25897,LP IPSP2400LGXIC AL DAR ALARABIA SA9720000002091330079901 Riyad Bank RIYADH 20241217SARIBLRIBL6BTMS11632801220 17DEC24 16:32:17,NONREF,Transfer,17/12/2024,"10,350.00",,16:32,17/12/2024,"40,359,852.18"
087071S010LY,APV MIDDLE EAST LTD TFR+ /INV/INV,INTEGRATED TELEC,Transfer,17/12/2024,"35,857.75",,16:28,17/12/2024,"40,349,502.18"
414071S00L9O,SCHWEITZER ENGINEEING TFR+ INV0045999,INV SETTLE,Transfer,17/12/2024,"4,759.71",,16:21,17/12/2024,"40,313,644.43"
DAF5-00039,COLLECINTG حسين رافع العنزي SALES BSF 912482 ID : B 1055600660 الدمام 0564080872 ALARABI FACTORY,NONREF,Cheque,19/12/2024,"2,570.00",,16:04,17/12/2024,"40,308,884.72"
906517S689Q9,ARABIAN SHIELD COOPERATI TFR+ INV0045916 - INV0045911 SA3545000000001754381001,24-0050020,Transfer,17/12/2024,"15,210.45",,15:58,17/12/2024,"40,306,314.72"
1604FT24352L2RVY,CONTROL AND ANTI CORRUPTION AUTHORI CONTROL AND ANTI CORRUPT 23173423807975100 2837 TFR+ SETTLEMENT OF BILL ALINMA BANK ALINMA BANK EX Rate : SAR 1.0000000,NONREF,Transfer,17/12/2024,"53,130.00",,15:41,17/12/2024,"40,291,104.27"
90063B3RXCTL,NEW TOWERS TRADING COMPA TFR+ 400348 1000019358 DEC,4.8E+11,Transfer,17/12/2024,"52,358.38",,15:21,17/12/2024,"40,237,974.27"
5.00003E+11,ETHAD ALRAJHI FOR REAL ESTSE COMPAN ETHAD ALRAJHI FOR REAL E /33/Repayment of Loans TFR+ INTB0165903593620903534E4C171072 AL RAJHI BANKING AND INV T CORP HEAD OFFICE RIYADH,NONREF,Transfer,17/12/2024,"39,335.75",,15:12,17/12/2024,"40,185,615.89"
YRTI-20669,LP IPSP2400LGFXY شركة سجى للطاقة SA9310000065915259000107 Saudi National Bank JEDDAH 20241217SANCBKNCBK6B82411429741843 17DEC24 14:30:09,NONREF,Transfer,17/12/2024,"2,300.00",,14:30,17/12/2024,"40,146,280.14"
596171S0049C,MY CLINIC INTER MEDICAL TFR+,TRF-ITCDEC24OPX,Transfer,17/12/2024,"1,011,577.85",,14:25,17/12/2024,"40,143,980.14"
EBCS-06068,FROM GLOBAL TECHNOLOGIES purchases INVESTMENT PURPOSE,NONREF,Transfer,17/12/2024,"30,781.02",,14:04,17/12/2024,"39,132,402.29"
YRTI-19002,LP IPSP2400LGDD6 MOHD IBRAHIM AL SHAMASY SA0680000106608010000563 Alrajhi Bank RIYADH 20241217SARJHIRJHI6BOPF11351194587 17DEC24 13:51:26,NONREF,Transfer,17/12/2024,"18,285.00",,13:51,17/12/2024,"39,101,621.27"
YRTI-18479,LP IPSP2400LGCNL مباركيه للفنادق المحدوده SA4580000341608011000112 Alrajhi Bank RIYADH 20241217SARJHIRJHI6BOPF11339213377 17DEC24 13:39:18,NONREF,Transfer,17/12/2024,"9,179.97",,13:39,17/12/2024,"39,083,336.27"
52773FIN161224,FINANCE DIVISION CINV240921268475 TFR+ 24/09/2024 BANK AL-JAZIRA HEAD OFFICE JEDDAH EX Rate : SAR 1.0000000 0800833051682 TRF FROM:SAUDI ARABIA,NONREF,Transfer,17/12/2024,"4,312.50",,13:21,17/12/2024,"39,074,156.30"
NCBK82424352APXS,ركه الشرق الأوسط للانترنت المحدودة TFR+ فواتير خدمات NATIONAL COMMERCIAL BANK NATIONAL COMMERCIAL BANK EX Rate : SAR 1.0000000 25056888000109 TRF FROM:SAUDI ARABIA,NONREF,Transfer,17/12/2024,"1,000,000.00",,13:05,17/12/2024,"39,069,843.80"
TJD2-00024,INCOME ايراد اتصﻼت عبدالمحسن محمد حمدي MIX 3 CHEQUE ID : B 1043476496 JED 0510018585 MIX CHEQUE,NONREF,Cheque,19/12/2024,"40,641.00",,12:57,17/12/2024,"38,069,843.80"
TJD2-00023,INCOME ايراد اتصﻼت عبدالمحسن محمد حمدي ALRAJI 9767 ID : B 1043476496 JED 0510018585 ALESAYI,NONREF,Cheque,19/12/2024,"20,996.00",,12:53,17/12/2024,"38,029,202.80"
762371R0109E,ASSYSTEM AND ALI AL-HARB TFR+,NONREF,Transfer,17/12/2024,"174,639.00",,12:36,17/12/2024,"38,008,206.80"
YRTI-15751,LP IPSP2400LG64D ALSHALAWI ALELAMI LILTIJ SA0580000157608010335009 Alrajhi Bank RIYADH 20241217SARJHIRJHI6BOPF11234081089 17DEC24 12:35:06,NONREF,Transfer,17/12/2024,"16,953.30",,12:35,17/12/2024,"37,833,567.80"
YRTI-14495,LP IPSP2400LG391 SYARA MEDDLE EAST COMPAN SA2080000577608010411224 Alrajhi Bank RIYADH 20241217SARJHIRJHI6BOPF11200063048 17DEC24 12:01:14,NONREF,Transfer,17/12/2024,"4,657.50",,12:01,17/12/2024,"37,816,614.50"
CTUJ-00021,DEPOSIT WITHDRAWAL 001-754381-202,NONREF,Transfer,17/12/2024,"1,458,715.28",,11:55,17/12/2024,"37,811,957.00"
CTUJ-00021,DEPOSIT WITHDRAWAL 001-754381-202,NONREF,Transfer,17/12/2024,"25,000,000.00",,11:55,17/12/2024,"36,353,241.72"
010141217H784513,MOHAMMED SAAD ALBAWARDY AND SONS CO TFR+ TRF DEC24 21 SAUDI INVESTMENT BANK RIYADH EX Rate : SAR 1.0000000 0138 588802 001 TRF FROM:SAUDI ARABIA,NONREF,Transfer,17/12/2024,"55,113.75",,11:40,17/12/2024,"11,353,241.72"
EBCQ-05609,FROM MODERN PIONEER SUPP . .,NONREF,Transfer,17/12/2024,"3,036.00",,11:27,17/12/2024,"11,298,127.97"
1604FT24352GW0N1,MERIDIEN MEDINA HOTEL 23173435030769200 INV OC TFR+ 24 AP DEC 21 SETTLEMENT OF BILL ALINMA BANK ALINMA BANK EX Rate : SAR 1.0000000 SA8405000068209666666001,NONREF,Transfer,17/12/2024,"98,325.00",,11:03,17/12/2024,"11,295,091.97"
NCBK501243526377,Saudi National Bank Operating Expenses INV N TFR+ InvoiceNumberCINV241021251126PONumb er119445 1251126 CC 0546 Group Technology 21 NATIONAL COMMERCIAL BANK NATIONAL COMMERCIAL BANK EX Rate : SAR 1.0000000,NONREF,Transfer,17/12/2024,"407,100.00",,10:49,17/12/2024,"11,196,766.97"
1604FT24352MWB3J,ALMRJAN ALAAMT LLTTWYR ALAQARI ALMH ALMRJAN ALAAMT LLTTWYR A 23173417270904704 TFR+ SETTLEMENT OF BILL ALINMA BANK ALINMA BANK EX Rate : SAR 1.0000000,NONREF,Transfer,17/12/2024,"77,625.00",,10:34,17/12/2024,"10,789,666.97"
94668352095112SK,شركة مراكز الاتصال expenses/Other TFR+ INV241011243474 INV241011243474 RIYAD BANK HEAD OFFICE RIYADH EX Rate : SAR 1.0000000 SA6720000002000166479940,NONREF,Transfer,17/12/2024,"193,200.00",,10:20,17/12/2024,"10,712,041.97"
NCBK82424352ALAC,ركة مزارع فقيه للدواجن مساهمة مقفل TFR+ كامل قيمة بضاعه جاهزة NATIONAL COMMERCIAL BANK NATIONAL COMMERCIAL BANK EX Rate : SAR 1.0000000 00913000000108 TRF FROM:SAUDI ARABIA,NONREF,Transfer,17/12/2024,"162,150.00",,9:49,17/12/2024,"10,518,841.97"
FT24351572713987,ALOTAIR TRADING TRAINDUSTRY GROUP ALOTAIR TRADING TRAINDUS SETTLEMENT OF BILLS TFR+ 72024 1الى فاتورة نت النزلاء فترة BANK AL B BANK AL BILAD EX Rate : SAR 1.0000000,NONREF,Transfer,17/12/2024,"140,070.00",,9:32,17/12/2024,"10,356,691.97"
NCBK82424351BBSL,شركة رضا للخدمات الغذااية المحدودة لخدمات الغذااية المحدودة Operating Expenses TFR+ Service/Utility Bills NATIONAL COMMERCIAL BANK NATIONAL COMMERCIAL BANK EX Rate : SAR 1.0000000,NONREF,Transfer,17/12/2024,"4,140.00",,9:31,17/12/2024,"10,216,621.97"
QST+091162811521,FOOD MANUFACTURING GROUP CO FOOD MANUFACTURING GROUP 2279671612 TFR+ Q0423UJ SAUDI INVESTMENT BANK RIYADH EX Rate : SAR 1.0000000,NONREF,Transfer,17/12/2024,"8,043.10",,9:30,17/12/2024,"10,212,481.97"
LPI202435108486,البنك الاسلامى للتنميه ريال نك الاسلامى للتنميه ريال /PAYROLL/ TFR+ SLY AL RAJHI BANKING AND INV T CORP HEAD OFFICE RIYADH EX Rate : SAR 1.0000000,NONREF,Transfer,17/12/2024,"498,093.75",,9:26,17/12/2024,"10,204,438.87"
FT24351571894113,MOUKHLSAH EST SETTLEMENT OF BILLS TFR+ 2024 فاتورة شهر نوفمبر BANK AL BILAD BANK AL BILAD EX Rate : SAR 1.0000000 SA9315000436132114970009 TRF FROM:SAUDI ARABIA,NONREF,Transfer,17/12/2024,"13,921.87",,9:15,17/12/2024,"9,706,345.12"
850271N01KWT,ABDUL LATIF JAMEEL SUMMI TFR+,SETTLEMENT,Transfer,17/12/2024,"205,252.50",,9:11,17/12/2024,"9,692,423.25"
654471R00ZJP,MADA CARPET CO TFR+,DUE INVOICE,Transfer,17/12/2024,"9,194.25",,1:41,17/12/2024,"9,487,170.75"
9.12164E+15,SPERRY SUN SAUDIA COMPAN TFR+,3800060353,Transfer,16/12/2024,"71,346.00",,16:46,16/12/2024,"9,477,976.50"
YRTI-27291,LP IPSP2400LE54M RAKYA INDUSTRY CO SA9360100085795029280001 Bank Aljazira JEDDAH 20241216SABJAZBJAZ2BTMS11643339984 16DEC24 16:43:42,NONREF,Transfer,16/12/2024,"1,838.85",,16:43,16/12/2024,"9,406,630.50"
760971R01LV5,BURCKHARDT COMPRESSION TFR+,INV241031259578,Transfer,16/12/2024,276,,16:00,16/12/2024,"9,404,791.65"
200GBMS243511809,"MOHD Y NAGHI MOTR(R) Others,FULL PAYMENT AS P TFR+ 7 INVOICES GULF INTERNATIONAL BANK BSC RIYADH EX Rate : SAR 1.0000000 SA1990000000020000004534",NONREF,Transfer,16/12/2024,"22,252.50",,15:18,16/12/2024,"9,404,515.65"
YRTI-22398,LP IPSP2400LDPBH المدفوعات الخليجية SA4610000024900000068706 Saudi National Bank JEDDAH 20241216SANCBKNCBK6B82411454203367 16DEC24 14:54:23,NONREF,Transfer,16/12/2024,"8,544.50",,14:54,16/12/2024,"9,382,263.15"
52742FIN151224,FINANCE DIVISION CINV240921268890:CN24092 TFR+ 29/09/2024 BANK AL-JAZIRA HEAD OFFICE JEDDAH EX Rate : SAR 1.0000000 0800833051682 TRF FROM:SAUDI ARABIA,NONREF,Transfer,16/12/2024,"1,853.80",,12:39,16/12/2024,"9,373,718.65"
FT24351723323440,Al Anwar Medical Hospital Al Anwar Medical Hospita SETTLEMENT OF BILLS TFR+ نوفمبر BANK AL BILAD BANK AL BILAD EX Rate : SAR 1.0000000,NONREF,Transfer,16/12/2024,"2,990.00",,11:50,16/12/2024,"9,371,864.85"
V241216110319283,401024601654811 :تنفيذ قضااى 401024601654811 :ذ قضااى /99/16425252 TFR+ AL RAJHI BANKING AND INV T CORP HEAD OFFICE RIYADH EX Rate : SAR 1.0000000,NONREF,Transfer,16/12/2024,"11,994.18",,11:43,16/12/2024,"9,368,874.85"
YRTI-12545,LP IPSP2400LCWNN ROAH ALMOBDAEN EST SA5520000003133133509940 Riyad Bank RIYADH 20241216SARIBLRIBL6BTMS11105329371 16DEC24 11:05:30,NONREF,Transfer,16/12/2024,"4,651.75",,11:05,16/12/2024,"9,356,880.67"
NCBK82424351AMSW,ALGHAYA PROFISNAL Operating Expenses TFR+ Service/Utility Bills Creative Edge Payment on account NATIONAL COMMERCIAL BANK NATIONAL COMMERCIAL BANK EX Rate : SAR 1.0000000,NONREF,Transfer,16/12/2024,"21,338.25",,11:00,16/12/2024,"9,352,228.92"
9466835109510XDA,شركة النايفات للتمويل أخرى / مصروفات TFR+ PYMJ004712 RIYAD BANK HEAD OFFICE RIYADH EX Rate : SAR 1.0000000 SA2720000002360395209940 TRF FROM:SAUDI ARABIA,NONREF,Transfer,16/12/2024,"43,625.25",,10:53,16/12/2024,"9,330,890.67"
EBN0-00558,FROM FACE CONTRACTING CO Inv Inv,NONREF,Transfer,16/12/2024,"26,529.47",,10:17,16/12/2024,"9,287,265.42"
9466835009510VKG,رع شركة المساندة لخدمات الاسناد وم TFR+ سداد فواتير payment for 5343 RIYAD BANK HEAD OFFICE RIYADH EX Rate : SAR 1.0000000 SA4420000003540523059940,NONREF,Transfer,16/12/2024,"208,304.10",,9:46,16/12/2024,"9,260,735.95"
ECOF41215H001051,MILLENNIUM COPTHORNE ALNASEEM HOTEL MILLENNIUM COPTHORNE ALN Operational Expenses TFR+ BANK AL-JAZIRA HEAD OFFICE JEDDAH EX Rate : SAR 1.0000000 SA5760100030995010119002,NONREF,Transfer,16/12/2024,"112,926.17",,9:34,16/12/2024,"9,052,431.85"
436671R00MW2,ERAM HOLDING COMPANY TFR+,INVOICE SETTLE.,Transfer,16/12/2024,"22,762.58",,9:28,16/12/2024,"8,939,505.68"
EPHR98124351N70E,ENGIE SOLUTION COMPANY. supplier TFR+ BANQUE SAUDI FRANSI HEAD OFFICE RIYADH EX Rate : SAR 1.0000000 SA5655000000072996600190 TRF FROM:SAUDI ARABIA 3769 34423,NONREF,Transfer,16/12/2024,"51,280.80",,9:25,16/12/2024,"8,916,743.10"
NCBK82424350AJST,ركة الغزاوي المهنية للاستشارات الق ي المهنية للاستشارات الق Operating Expenses TFR+ Service/Utility Bills NATIONAL COMMERCIAL BANK NATIONAL COMMERCIAL BANK EX Rate : SAR 1.0000000,NONREF,Transfer,16/12/2024,"10,481.10",,9:17,16/12/2024,"8,865,462.30"
YRTI-08435,LP IPSP2400LCI9F MZAMEEZ LTD CO SA7480000678608010333228 Alrajhi Bank RIYADH 20241216SARJHIRJHI6BOPF10910185309 16DEC24 09:10:25,NONREF,Transfer,16/12/2024,"5,985.75",,9:10,16/12/2024,"8,854,981.20"
TT CPMN0JE2AIRNN,"CHARGES SAR 130.00 704471N011FM TOTAL VAT SAR19,5 ON CHARGE AMOUNT SAR130,",608973,Charges,16/12/2024,,-149.5,6:00,16/12/2024,"8,848,995.45"
TT CPMN0JE2AIRNN,OMNI DIGITAL EXPERIENCE LLC 704471N011FM EX Rate : SAR 3.7550000,608973,Transfer,16/12/2024,,"-1,338,788.93",6:00,16/12/2024,"8,849,144.95"
LP CPMN2XDFTIRN,"CHARGES SAR 7.00 749171Q00VKH CORP OPS DIV RIYADH TOTAL VAT SAR1,05 ON CHARGE AMOUNT SAR7,",609609,Charges,16/12/2024,,-8.05,2:35,16/12/2024,"10,187,933.88"
LP CPMN2XDFTIRN,SAUDI FRANSI CAPITAL COMPANY 749171Q00VKH BANQUE SAUDI FRANSI CORP OPS DIV RIYADH EX Rate : SAR 1.0000000 BANQUE SAUDI FRANSI TRF TO:SAUDI ARABIA,609609,Transfer,16/12/2024,,"-201,250.00",2:35,16/12/2024,"10,187,941.93"
LP CPMN2XDFSIRN,"CHARGES SAR 7.00 222471Q011FA THE NATIONAL COMMERCIAL BANK TOTAL VAT SAR1,05 ON CHARGE AMOUNT SAR7,",609611,Charges,16/12/2024,,-8.05,2:35,16/12/2024,"10,389,191.93"
LP CPMN2XDFSIRN,DAWIYAT INTEGRATED TELECOM 222471Q011FA INTEGRATED TELECOM CO. NATIONAL COMMERCIAL BANK THE NATIONAL COMMERCIAL BANK EX Rate : SAR 1.0000000 NATIONAL COMMERCIAL BANK,609611,Transfer,16/12/2024,,"-5,000,000.00",2:35,16/12/2024,"10,389,199.98"
213871Q0204A,ALMOUWASAT MADINA TFR+,V8058 PYT NOV24,Transfer,16/12/2024,"163,902.60",,2:35,16/12/2024,"15,389,199.98"
YRTJ-00657,LP IPSP2400LBWY4 شركة شاويز المحدوده SA0405000068202733597000 Alinma bank RIYADH 20241216SAINMAINMA6BXXX12109100301 15DEC24 21:09:48,NONREF,Transfer,15/12/2024,"11,971.51",,21:09,15/12/2024,"15,225,297.38"
BTPM-00926,242761608 169 242761608 SADAD:5663885541,MANUAL 4163940,Transfer,15/12/2024,,"-7,657.00",20:10,15/12/2024,"15,213,325.87"
677371Q0123J,BINSALEM SAMAR 072-124415-001 /RFB/ITC CWF PAYMENT,609612,Transfer,15/12/2024,,"-800,000.00",18:27,15/12/2024,"15,220,982.87"
590971Q003JU,ALKHABEER WORKING CAPITA TFR+,PO-01242/01241,Transfer,15/12/2024,"87,348.70",,17:28,15/12/2024,"16,020,982.87"
733771K00OY5,ARABIAN PAPER PRODCO TFR+,WT241109,Transfer,15/12/2024,"53,130.90",,16:17,15/12/2024,"15,933,634.17"
YRTI-88163,LP IPSP2400LB5T1 MALAHI CO SA2030400108057189910034 Arab National Bank RIYADH 20241215SAARNBARNB1B92311606136595 15DEC24 16:06:23,NONREF,Transfer,15/12/2024,"15,291.55",,16:06,15/12/2024,"15,880,503.27"
SAMAERP24350WII4,SAMASARI TFR+ uthority HEAD OFFICE RIYADH EX Rate : SAR 1.0000000 AMASARI TRF FROM:SAUDI ARABIA 15DEC24 14:42:03,NONREF,Transfer,15/12/2024,"194,350.00",,14:42,15/12/2024,"15,865,211.72"
781971Q01FH7,AIBIS RIYADH HOTEL TFR+,1010206051,Transfer,15/12/2024,"44,298.00",,14:39,15/12/2024,"15,670,861.72"
593771Q012C3,CAREEM DELEVERIES CO TFR+,GTG-INTEGRATED,Transfer,15/12/2024,"116,267.30",,14:37,15/12/2024,"15,626,563.72"
O00192321848,OPS AP INTERIM PAY ACCOUNT OPS AP INTERIM PAY ACCOU KSA CINV241111285743U616 TFR+ EMIRATES NBD BANK PJSC EMIRATES BANK INTERNATIO NAL EX Rate : SAR 1.0000000,NONREF,Transfer,15/12/2024,"1,631,774.42",,14:30,15/12/2024,"15,510,296.42"
5.00003E+11,KUN SPORTS COMPANY TFR+ AL RAJHI BANKING AND INV T CORP HEAD OFFICE RIYADH EX Rate : SAR 1.0000000 SA1780000577608010071002 TRF FROM:SAUDI ARABIA,NONREF,Transfer,15/12/2024,"98,000.00",,14:10,15/12/2024,"13,878,522.00"
YRTI-83066,LP IPSP2400LASRU ن اﻻسﻼمي اﻷمين العام SA1105000068267777777000 Alinma bank RIYADH 20241215SAINMAINMA4BXXX11403153364 15DEC24 14:04:01,NONREF,Transfer,15/12/2024,"3,450.00",,14:04,15/12/2024,"13,780,522.00"
V241215123952429,401014602417162 :تنفيذ قضااى 401014602417162 :ذ قضااى /99/16378355 TFR+ AL RAJHI BANKING AND INV T CORP HEAD OFFICE RIYADH EX Rate : SAR 1.0000000,NONREF,Transfer,15/12/2024,"1,500.00",,13:11,15/12/2024,"13,777,072.00"
YRTI-80417,LP IPSP2400LAN34 ة اﻷلف للخدمات الفندقيه SA1410000000900000351103 Saudi National Bank JEDDAH 20241215SANCBKNCBK6B82411303500961 15DEC24 13:03:45,NONREF,Transfer,15/12/2024,"5,554.50",,13:03,15/12/2024,"13,775,572.00"
YRTI-76028,LP IPSP2400LADL6 ATTA UR RAHMAN HASEEB U SA82550000000D8230500191 Banque Saudi Fransi RIYADH 20241215SABSFRBSFR6B98111113550924 15DEC24 11:14:15,NONREF,Transfer,15/12/2024,"13,500.00",,11:14,15/12/2024,"13,770,017.50"
LP IPSP2400LAC5Y,"20241215SASABBSABB6BNET11106088508 TOT CHG SAR 1.00 NATIONAL COMMERCIAL BANK NATIONAL COMMERCIAL BANK VATABLE SAR 1.00 VAT AMT SAR 0.15 STANDARD RATE AT 000000000000015 TOTAL VAT SAR0,15 ON CHARGE AMOUNT SAR1,",MANUAL 4357109,Charges,15/12/2024,,-1.15,11:06,15/12/2024,"13,756,517.50"
LP IPSP2400LAC5Y,HASSAN AHMED HASSAN ALMUSWADI 20241215SASABBSABB6BNET11106088508 SA2010000088200000169508NATIONAL COMMERCIAL BANK NATIONAL COMMERCIAL BANKEX Rate SAR 1.0000000,MANUAL 4357109,Transfer,15/12/2024,,"-6,810.88",11:06,15/12/2024,"13,756,518.65"
170471M00AQV,SPEED PRINT FOR PRINTING 011-306925-001,609532,Transfer,15/12/2024,,"-31,733.10",11:05,15/12/2024,"13,763,329.53"
LP CPMN2XAGYIRN,"CHARGES SAR 7.00 389871N00U3P ALINMA BANK TOTAL VAT SAR1,05 ON CHARGE AMOUNT SAR7,",609516,Charges,15/12/2024,,-8.05,11:05,15/12/2024,"13,795,062.63"
LP CPMN2XAGYIRN,MONAERAH OMAR ALFOWZAN 389871N00U3P /RFB/ITC RENT APYMENT ALINMA BANK ALINMA BANK EX Rate : SAR 1.0000000 ALINMA BANK TRF TO:SAUDI ARABIA,609516,Transfer,15/12/2024,,"-37,576.00",11:05,15/12/2024,"13,795,070.68"
LP CPMN2XAGXIRN,"CHARGES SAR 7.00 455871N00JHD T CORP BR 161 JEDDAH TOTAL VAT SAR1,05 ON CHARGE AMOUNT SAR7,",609555,Charges,15/12/2024,,-8.05,11:05,15/12/2024,"13,832,646.68"
LP CPMN2XAGXIRN,SHBKAAT ALJAWHRH EST 455871N00JHD AL RAJHI BANKING AND INV T CORP BR 161 JEDDAH EX Rate : SAR 1.0000000 AL RAJHI BANKING AND INV T CORP,609555,Transfer,15/12/2024,,"-42,665.00",11:05,15/12/2024,"13,832,654.73"
LP CPMN2XAGWIRN,"CHARGES SAR 7.00 607671N012S6 RIYADH TOTAL VAT SAR1,05 ON CHARGE AMOUNT SAR7,",609183,Charges,15/12/2024,,-8.05,11:05,15/12/2024,"13,875,319.73"
LP CPMN2XAGWIRN,MIDDLE EAST AND AFRICA GROUP TECH. 607671N012S6 SAUDI INVESTMENT BANK RIYADH EX Rate : SAR 1.0000000 SAUDI INVESTMENT BANK TRF TO:SAUDI ARABIA,609183,Transfer,15/12/2024,,"-47,293.75",11:05,15/12/2024,"13,875,327.78"
LP CPMN2XAGVIRN,"CHARGES SAR 7.00 870071N00XJ8 THE NATIONAL COMMERCIAL BANK TOTAL VAT SAR1,05 ON CHARGE AMOUNT SAR7,",609552,Charges,15/12/2024,,-8.05,11:05,15/12/2024,"13,922,621.53"
LP CPMN2XAGVIRN,SALEM SALEH SAEED BABGI 870071N00XJ8 /RFB/ITC RENT PAYMENT NATIONAL COMMERCIAL BANK THE NATIONAL COMMERCIAL BANK EX Rate : SAR 1.0000000 NATIONAL COMMERCIAL BANK,609552,Transfer,15/12/2024,,"-50,000.00",11:05,15/12/2024,"13,922,629.58"
408671N013GD,AL HAMMAM HAMMAM 065-030777-001,609548,Transfer,15/12/2024,,"-55,000.00",11:05,15/12/2024,"13,972,629.58"
LP CPMN2XAGUIRN,"CHARGES SAR 7.00 589871N00RS5 ALINMA BANK TOTAL VAT SAR1,05 ON CHARGE AMOUNT SAR7,",609547,Charges,15/12/2024,,-8.05,11:05,15/12/2024,"14,027,629.58"
LP CPMN2XAGUIRN,SAAD ABDULAH ALANEZAN 589871N00RS5 /RFB/ITC RENT PAYMENT ALINMA BANK ALINMA BANK EX Rate : SAR 1.0000000 ALINMA BANK TRF TO:SAUDI ARABIA,609547,Transfer,15/12/2024,,"-157,000.00",11:05,15/12/2024,"14,027,637.63"
LP CPMN2XAGTIRN,"CHARGES SAR 7.00 210171N00MA2 ALINMA BANK TOTAL VAT SAR1,05 ON CHARGE AMOUNT SAR7,",609550,Charges,15/12/2024,,-8.05,11:05,15/12/2024,"14,184,637.63"
LP CPMN2XAGTIRN,MUSHABBAB SAAD ALQAHTANI 210171N00MA2 ALINMA BANK ALINMA BANK EX Rate : SAR 1.0000000 ALINMA BANK TRF TO:SAUDI ARABIA,609550,Transfer,15/12/2024,,"-170,000.00",11:05,15/12/2024,"14,184,645.68"
LP CPMN2XAGSIRN,"CHARGES SAR 7.00 213371N013X5 THE NATIONAL COMMERCIAL BANK TOTAL VAT SAR1,05 ON CHARGE AMOUNT SAR7,",FIN SETT 4357710,Charges,15/12/2024,,-8.05,11:05,15/12/2024,"14,354,645.68"
LP CPMN2XAGSIRN,ABDULRAHMAN HASSAN ALSHEHRI 213371N013X5 ITC CASH WORKING FUND NATIONAL COMMERCIAL BANK THE NATIONAL COMMERCIAL BANK EX Rate : SAR 1.0000000 NATIONAL COMMERCIAL BANK,FIN SETT 4357710,Transfer,15/12/2024,,"-170,536.00",11:05,15/12/2024,"14,354,653.73"
LP CPMN2XAGRIRN,"CHARGES SAR 7.00 067471N00OA0 ALINMA BANK TOTAL VAT SAR1,05 ON CHARGE AMOUNT SAR7,",609531,Charges,15/12/2024,,-8.05,11:05,15/12/2024,"14,525,189.73"
LP CPMN2XAGRIRN,شركة اﻻفكار 067471N00OA0 ALINMA BANK ALINMA BANK EX Rate : SAR 1.0000000 ALINMA BANK TRF TO:SAUDI ARABIA,609531,Transfer,15/12/2024,,"-233,171.70",11:05,15/12/2024,"14,525,197.78"
LP CPMN2XAGQIRN,"CHARGES SAR 7.00 379071N00FCN KING ABDUL AZIZ ST ALHOB AR TOTAL VAT SAR1,05 ON CHARGE AMOUNT SAR7,",609576,Charges,15/12/2024,,-8.05,11:05,15/12/2024,"14,758,369.48"
LP CPMN2XAGQIRN,شركه اﻻتصاﻻت المتنقله السعوديه 379071N00FCN ARAB NATIONAL BANK KING ABDUL AZIZ ST ALHOB AR EX Rate : SAR 1.0000000 ARAB NATIONAL BANK TRF TO:SAUDI ARABIA,609576,Transfer,15/12/2024,,"-250,000.00",11:05,15/12/2024,"14,758,377.53"
LP CPMN2XAGPIRN,"CHARGES SAR 7.00 471771N00ZMH HEAD OFFICE RIYADH TOTAL VAT SAR1,05 ON CHARGE AMOUNT SAR7,",609491,Charges,15/12/2024,,-8.05,11:05,15/12/2024,"15,008,377.53"
LP CPMN2XAGPIRN,BINGHAITH TRAVEL 471771N00ZMH /RFB/ITC TICKETS INVOICE PAYMENT RIYAD BANK HEAD OFFICE RIYADH EX Rate : SAR 1.0000000 RIYAD BANK TRF TO:SAUDI ARABIA,609491,Transfer,15/12/2024,,"-250,838.22",11:05,15/12/2024,"15,008,385.58"
LP CPMN2XAGOIRN,"CHARGES SAR 7.00 651371N00HBB DOLLAR CLEARING A/C JEDD AH TOTAL VAT SAR1,05 ON CHARGE AMOUNT SAR7,",609554,Charges,15/12/2024,,-8.05,11:05,15/12/2024,"15,259,223.80"
LP CPMN2XAGOIRN,ALRAMLLI LLMQAWLAAT COMPANY 651371N00HBB BANK AL-JAZIRA DOLLAR CLEARING A/C JEDD AH EX Rate : SAR 1.0000000 BANK AL-JAZIRA TRF TO:SAUDI ARABIA,609554,Transfer,15/12/2024,,"-1,802,470.33",11:05,15/12/2024,"15,259,231.85"
LP CPMN2XAGNIRN,"CHARGES SAR 7.00 416771N0244Z KING ABDUL AZIZ ST ALHOB AR TOTAL VAT SAR1,05 ON CHARGE AMOUNT SAR7,",609594,Charges,15/12/2024,,-8.05,11:05,15/12/2024,"17,061,702.18"
LP CPMN2XAGNIRN,HUAWEI TECH. INVESTMENT SAUDI ARABI 416771N0244Z /RFB/ITC INVOICE PAYMENT ARAB NATIONAL BANK KING ABDUL AZIZ ST ALHOB AR EX Rate : SAR 1.0000000 ARAB NATIONAL BANK,609594,Transfer,15/12/2024,,"-5,000,000.00",11:05,15/12/2024,"17,061,710.23"
LP CPMN2XAGMIRN,"CHARGES SAR 7.00 823771M00H5D THE NATIONAL COMMERCIAL BANK TOTAL VAT SAR1,05 ON CHARGE AMOUNT SAR7,",609560,Charges,15/12/2024,,-8.05,11:05,15/12/2024,"22,061,710.23"
LP CPMN2XAGMIRN,FRANCISCO DAYAPAN 823771M00H5D /RFB/ITC CWF PAYMENT NATIONAL COMMERCIAL BANK THE NATIONAL COMMERCIAL BANK EX Rate : SAR 1.0000000 NATIONAL COMMERCIAL BANK,609560,Transfer,15/12/2024,,"-2,663.06",11:05,15/12/2024,"22,061,718.28"
LP CPMN2XAGLIRN,"CHARGES SAR 7.00 188271M00F5D THE NATIONAL COMMERCIAL BANK TOTAL VAT SAR1,05 ON CHARGE AMOUNT SAR7,",609546,Charges,15/12/2024,,-8.05,11:05,15/12/2024,"22,064,381.34"
LP CPMN2XAGLIRN,NAQEL COMPANY 188271M00F5D /RFB/ITC INVOICE PAYMENT NATIONAL COMMERCIAL BANK THE NATIONAL COMMERCIAL BANK EX Rate : SAR 1.0000000 NATIONAL COMMERCIAL BANK,609546,Transfer,15/12/2024,,"-10,746.75",11:05,15/12/2024,"22,064,389.39"
191571M00DC4,SPEED PRINT FOR PRINTING 011-306925-001,609538,Transfer,15/12/2024,,"-1,610.00",11:05,15/12/2024,"22,075,136.14"
730171M00IWT,AWADH AHMED 003-196912-001,609541,Transfer,15/12/2024,,"-2,094.50",11:05,15/12/2024,"22,076,746.14"
384571M006E4,ALUTARY MOHAMMED 013-430459-001 /RFB/ITC CWF PAYMENT,609562,Transfer,15/12/2024,,"-4,628.02",11:05,15/12/2024,"22,078,840.64"
371871M008HL,ALUTARY MOHAMMED 013-430459-001 /RFB/ITC CWF PAYMENT,609563,Transfer,15/12/2024,,"-5,500.00",11:05,15/12/2024,"22,083,468.66"
174071M007IU,ALUTARY MOHAMMED 013-430459-001 /RFB/ITC CWF PAYMENT,609559,Transfer,15/12/2024,,"-6,124.55",11:05,15/12/2024,"22,088,968.66"
663471M009HL,ALUTARY MOHAMMED 013-430459-001 /RFB/ITC CWF PAYMENT,609564,Transfer,15/12/2024,,"-10,395.35",11:05,15/12/2024,"22,095,093.21"
LP CPMN2XAGKIRN,"CHARGES SAR 7.00 129971N01FRE THE NATIONAL COMMERCIAL BANK TOTAL VAT SAR1,05 ON CHARGE AMOUNT SAR7,",FIN SETT 4357718,Charges,15/12/2024,,-8.05,11:05,15/12/2024,"22,105,488.56"
LP CPMN2XAGKIRN,SARAH NASSER S ALQAHTANI 129971N01FRE NATIONAL COMMERCIAL BANK THE NATIONAL COMMERCIAL BANK EX Rate : SAR 1.0000000 NATIONAL COMMERCIAL BANK TRF TO:SAUDI ARABIA,FIN SETT 4357718,Transfer,15/12/2024,,"-21,040.00",11:05,15/12/2024,"22,105,496.61"
LP CPMN2XAGJIRN,"CHARGES SAR 7.00 022471M00CCK HEAD OFFICE RIYADH TOTAL VAT SAR1,05 ON CHARGE AMOUNT SAR7,",609540,Charges,15/12/2024,,-8.05,11:05,15/12/2024,"22,126,536.61"
LP CPMN2XAGJIRN,CROWNE PLAZA RIYADH PALACE 022471M00CCK RIYAD BANK HEAD OFFICE RIYADH EX Rate : SAR 1.0000000 RIYAD BANK TRF TO:SAUDI ARABIA,609540,Transfer,15/12/2024,,"-23,401.36",11:05,15/12/2024,"22,126,544.66"
286471N02186,ALAMRI IBRAHIM 615-107638-001,FIN SETT 4357717,Transfer,15/12/2024,,"-23,709.00",11:05,15/12/2024,"22,149,946.02"
214271M008HW,SA SABB 001-754381-004 TFR+,INTER CO 191,Transfer,15/12/2024,"7,500,000.00",,11:04,15/12/2024,"22,173,655.02"
9004Z5K7T4XL,WORLEY PARSONS ARABIA LT TFR+ SALAM-ITC/INV/PO''WAL-619/ITC MONTH,PAYMENT NO-2340,Transfer,15/12/2024,"327,750.00",,10:16,15/12/2024,"14,673,655.02"
NCBK82424347BEMY,شركة الحمراني العالمية شركة مساهمة اني العالمية شركة مساهمة Operating Expenses TFR+ Service/Utility Bills NATIONAL COMMERCIAL BANK NATIONAL COMMERCIAL BANK EX Rate : SAR 1.0000000,NONREF,Transfer,15/12/2024,"29,618.25",,10:06,15/12/2024,"14,345,905.02"
NCBK82424347BCDM,شركة مجموعة الخريف مساهمة مقفله TFR+ Service/Utility Bills NATIONAL COMMERCIAL BANK NATIONAL COMMERCIAL BANK EX Rate : SAR 1.0000000 65900000318206 TRF FROM:SAUDI ARABIA,NONREF,Transfer,15/12/2024,"235,828.20",,10:05,15/12/2024,"14,316,286.77"
NCBK82424347BCOD,ركه التميز الفريد للفنادق والمنتجع الفريد للفنادق والمنتجع مصاريف تشغيل TFR+ فواتير خدمات PAYMENT FOR FEBMAY 2024 NATIONAL COMMERCIAL BANK NATIONAL COMMERCIAL BANK,NONREF,Transfer,15/12/2024,"80,943.90",,10:04,15/12/2024,"14,080,458.57"
NCBK82424347BBRR,فندق العنود نوفوتيل Operating Expenses TFR+ Operational Maintenance NATIONAL COMMERCIAL BANK NATIONAL COMMERCIAL BANK EX Rate : SAR 1.0000000 27166000000105 TRF FROM:SAUDI ARABIA,NONREF,Transfer,15/12/2024,"21,528.00",,10:02,15/12/2024,"13,999,514.67"
ECOF41214H000369,MISHWAR UNITED CO شراء بضاعة TFR+ 2024 ة الربع الاول من عام BANK AL-JAZIRA HEAD OFFICE JEDDAH EX Rate : SAR 1.0000000 SA4160100001395008406004 TRF FROM:SAUDI ARABIA,NONREF,Transfer,15/12/2024,"26,082.00",,10:01,15/12/2024,"13,977,986.67"
P132879631EBPLUS,AL MABANI GENERAL CONTRACTOR CO. AL MABANI GENERAL CONTRA COMPANIES FOR OTHER PURP TFR+ Settlement of Invoice No. 241021265 401 ARAB NATIONAL BANK RIYADH BRANCH,NONREF,Transfer,15/12/2024,"26,811.33",,9:54,15/12/2024,"13,951,904.67"
PA243458583663,شركة بيـان للمعلومات الااتمانية ـان للمعلومات الااتمانية TFR+ ALINMA BANK EX Rate : SAR 1.0000000 SA1405000068210000055000 TRF FROM:SAUDI ARABIA KINGFAHAD STREET RIYADH,NONREF,Transfer,15/12/2024,"3,312.00",,9:22,15/12/2024,"13,925,093.34"
PA243458583662,شركة بيـان للمعلومات الااتمانية ـان للمعلومات الااتمانية TFR+ ALINMA BANK EX Rate : SAR 1.0000000 SA1405000068210000055000 TRF FROM:SAUDI ARABIA KINGFAHAD STREET RIYADH,NONREF,Transfer,15/12/2024,"29,325.00",,9:22,15/12/2024,"13,921,781.34"
PA243458583661,شركة بيـان للمعلومات الااتمانية ـان للمعلومات الااتمانية TFR+ ALINMA BANK EX Rate : SAR 1.0000000 SA1405000068210000055000 TRF FROM:SAUDI ARABIA KINGFAHAD STREET RIYADH,NONREF,Transfer,15/12/2024,"3,312.00",,9:22,15/12/2024,"13,892,456.34"
PA243458583660,شركة بيـان للمعلومات الااتمانية ـان للمعلومات الااتمانية TFR+ ALINMA BANK EX Rate : SAR 1.0000000 SA1405000068210000055000 TRF FROM:SAUDI ARABIA KINGFAHAD STREET RIYADH,NONREF,Transfer,15/12/2024,"29,325.00",,9:22,15/12/2024,"13,889,144.34"
YRTI-04693,LP IPSP2400L6HH8 MORADI MOHAMAD MURSHID A SA8180000282608011203980 Alrajhi Bank RIYADH 20241213SARJHIRJHI2BOPF10108337385 13DEC24 01:09:07,NONREF,Transfer,15/12/2024,200,,1:09,15/12/2024,"13,859,819.34"
SAUDI ARABIAN OI,2000241641 /INV//CINV241131280054 TFR+,2000241641,Transfer,15/12/2024,"216,315.00",,22:24,15/12/2024,"13,859,619.34"
ZAD1-50006,MCINV0006284 19MAY2022 BS00200001 I24000646A I24000646A,NONREF,Transfer,12/12/2024,"178,250.00",,20:00,12/12/2024,"13,643,304.34"
YRTI-31654,LP IPSP2400L5LUP ROSH RAYHAAN BY ROTANA SA3930400108095224760015 Arab National Bank RIYADH 20241212SAARNBARNB1B01711733698743 12DEC24 17:33:29,NONREF,Transfer,12/12/2024,"11,730.00",,17:33,12/12/2024,"13,465,054.34"
113371N01H8D,AL TAMIMI AND COMPANY TFR+,1120-ITC,Transfer,12/12/2024,"82,689.60",,17:30,12/12/2024,"13,453,324.34"
566771N00BLX,ALSHAYA INT. TRADING CO. TFR+ ALSHAYA/DEC-24,427879/822464,Transfer,12/12/2024,"455,579.72",,16:48,12/12/2024,"13,370,634.74"
NCBK82424347AWEI,S.B. OF ENGI. ENPPI مصاريف تشغيل TFR+ فواتير خدمات NATIONAL COMMERCIAL BANK NATIONAL COMMERCIAL BANK EX Rate : SAR 1.0000000 95400005556907 TRF FROM:SAUDI ARABIA,NONREF,Transfer,12/12/2024,"127,650.00",,15:20,12/12/2024,"12,915,055.02"
664971N014SK,"FCC CONSTRUCCION, S.A CO TFR+ /RFB/FCC KSA BRANCH /INV/INV231021131234 /INV/INV2410212440741",SALAM,Transfer,12/12/2024,"144,900.00",,15:13,12/12/2024,"12,787,405.02"
830371M00SXZ,KING ABDULLAH FINANCIAL TFR+,809054,Transfer,12/12/2024,"74,520.00",,15:12,12/12/2024,"12,642,505.02"
9058C89QKPFT,SUBSEA SEVEN SAUDI CO. L TFR+ 3800010770 INV241131286951 CN241131286937,6.53624E+11,Transfer,12/12/2024,"30,057.29",,14:09,12/12/2024,"12,567,985.02"
YRTI-20100,LP IPSP2400L4YFO MUNIF AMER ABDULLAH ALNA SA9080000577608010026329 Alrajhi Bank RIYADH 20241212SARJHIRJHI6BOPF11339078254 12DEC24 13:40:11,NONREF,Transfer,12/12/2024,"15,000.00",,13:40,12/12/2024,"12,537,927.73"
9466834709510JFZ,ركة عوااد الاصول المالية شركة مساه الاصول المالية شركة مساه expenses/Other TFR+ INV241001275720 RIYAD BANK HEAD OFFICE RIYADH EX Rate : SAR 1.0000000,NONREF,Transfer,12/12/2024,"34,242.02",,13:39,12/12/2024,"12,522,927.73"
9466834709510J6V,شركة ربط الشبكات السعودية المحدودة لشبكات السعودية المحدودة الفواتير / مشتريات TFR+ RIYAD BANK HEAD OFFICE RIYADH EX Rate : SAR 1.0000000 SA3920000003461214019940,NONREF,Transfer,12/12/2024,"168,893.84",,13:04,12/12/2024,"12,488,685.71"
9033M7CJR4JT,SAUDI INFORMATION TECHNO TFR+,INV240911276231,Transfer,12/12/2024,"5,750.00",,13:01,12/12/2024,"12,319,791.87"
5.00003E+11,UNICHARM GULF HYGIENIC INDUSTRIES TFR+ AL RAJHI BANKING AND INV T CORP HEAD OFFICE RIYADH EX Rate : SAR 1.0000000 SA5880000362608014488888 TRF FROM:SAUDI ARABIA,NONREF,Transfer,12/12/2024,"65,550.00",,12:59,12/12/2024,"12,314,041.87"
723971M01CG3,PORTS DEVELOPMENT COMPAN TFR+,INTERNET,Transfer,12/12/2024,"138,000.00",,12:29,12/12/2024,"12,248,491.87"
ECOF41212H000316,UL ELECTRONIC WASTE TREATMENT UL ELECTRONIC WASTE TREA Operational Expenses TFR+ BANK AL-JAZIRA HEAD OFFICE JEDDAH EX Rate : SAR 1.0000000 SA9660000000060675912001,NONREF,Transfer,12/12/2024,"8,223.65",,12:21,12/12/2024,"12,110,491.87"
YRTI-15269,LP IPSP2400L4OEH ة مسارات الشبكة المحدودة SA5910000065900000257706 Saudi National Bank JEDDAH 20241212SANCBKNCBK6B82411149924822 12DEC24 11:49:17,NONREF,Transfer,12/12/2024,"18,285.00",,11:49,12/12/2024,"12,102,268.22"
9002283NDLGX,TAJEER INTERNATIONAL COM TFR+ CONNECTION FEES INV 240921226891,ELECTRONICPAY,Transfer,12/12/2024,"16,836.00",,11:44,12/12/2024,"12,083,983.22"
9001W7WLP1M9,TAJEER INTERNATIONAL COM TFR+ CONNECTION FEES INV 139054,ELECTRONICPAY,Transfer,12/12/2024,"16,836.00",,11:44,12/12/2024,"12,067,147.22"
NCBK82424346AXKR,الشركه الكيميااية السعودية القابضة TFR+ Service/Utility Bills NATIONAL COMMERCIAL BANK NATIONAL COMMERCIAL BANK EX Rate : SAR 1.0000000 65900000233803 TRF FROM:SAUDI ARABIA,NONREF,Transfer,12/12/2024,"71,332.20",,11:33,12/12/2024,"12,050,311.22"
5.00003E+11,KUN SPORTS COMPANY TFR+ AL RAJHI BANKING AND INV T CORP HEAD OFFICE RIYADH EX Rate : SAR 1.0000000 SA1780000577608010071002 TRF FROM:SAUDI ARABIA,NONREF,Transfer,12/12/2024,"97,000.00",,11:27,12/12/2024,"11,978,979.02"
5.00003E+11,MAEN TAIBAH HOTAIL COMPANY MAEN TAIBAH HOTAIL COMPA INTB0292141541988888257E TFR+ AL RAJHI BANKING AND INV T CORP HEAD OFFICE RIYADH EX Rate : SAR 1.0000000,NONREF,Transfer,12/12/2024,"66,240.00",,10:12,12/12/2024,"11,881,979.02"
FT24347927810673,FAKHRUDDIN KADERBHAI TRADING CO FAKHRUDDIN KADERBHAI TRA SETTLEMENT OF BILLS TFR+ INTERNET PAYMENT CINV240921249143 BANK AL BILAD BANK AL BILAD EX Rate : SAR 1.0000000,NONREF,Transfer,12/12/2024,"4,140.00",,9:58,12/12/2024,"11,815,739.02"
SA2OL2412120000J,LANDMARK ARABIA COMPANY TFR+ /Narr/BRT 1201000288 Misc Payment STANDARD CHARTERED CAPIT AL (SAUDI A STANDARD CHARTERED CAPIT AL SAUDI EX Rate : SAR 1.0000000,NONREF,Transfer,12/12/2024,"50,252.70",,9:57,12/12/2024,"11,811,599.02"
5.00003E+11,VALLEY ALMADINA INTB0277977305770444001E TFR+ AL RAJHI BANKING AND INV T CORP HEAD OFFICE RIYADH EX Rate : SAR 1.0000000 SA6980000577608010444001 TRF FROM:SAUDI ARABIA,NONREF,Transfer,12/12/2024,"66,240.00",,9:45,12/12/2024,"11,761,346.32"
200GTSA243470512,"SAUDI GLOBAL PORTS CO. L.L.C. SAUDI GLOBAL PORTS CO. L Others,8 INV TFR+ GULF INTERNATIONAL BANK BSC RIYADH EX Rate : SAR 1.0000000",NONREF,Transfer,12/12/2024,"239,769.91",,9:40,12/12/2024,"11,695,106.32"
NCBK82424346BCHF,ؤسسة تشييد القلعة للمقاولات العامة القلعة للمقاولات العامة مصاريف تشغيل TFR+ فواتير خدمات NATIONAL COMMERCIAL BANK NATIONAL COMMERCIAL BANK EX Rate : SAR 1.0000000,NONREF,Transfer,12/12/2024,"22,425.00",,9:37,12/12/2024,"11,455,336.41"
996CT28HQ0000004,هيية السوق الماليه /Bulk Sarie Payments/ TFR+ NATIONAL COMMERCIAL BANK NATIONAL COMMERCIAL BANK EX Rate : SAR 1.0000000 65900000564510 TRF FROM:SAUDI ARABIA CIF-58156838000008,NONREF,Transfer,12/12/2024,"37,191.00",,9:26,12/12/2024,"11,432,911.41"
9038P52AOI0P,SNAMPROGETTI SAUDI ARABI TFR+ PAYM.VARIOUS INVS,4.46379E+12,Transfer,12/12/2024,"465,259.15",,9:16,12/12/2024,"11,395,720.41"
900316SR67P9,SAUDI INFORMATION TECHNO TFR+,INV241012276231,Transfer,12/12/2024,"222,970.05",,1:14,12/12/2024,"10,930,461.26"
334071M01DYU,SOCPA TFR+,BILL/2024/2386,Transfer,12/12/2024,"163,871.55",,1:06,12/12/2024,"10,707,491.21"
ALMARAI COMPANY,INV241011275487 TFR+,1.00015E+13,Transfer,12/12/2024,"85,866.67",,22:27,12/12/2024,"10,543,619.66"
SAUDI ARABIAN OI,2000237391 /INV//CINV241031274709 TFR+,2000237391,Transfer,12/12/2024,"301,485.00",,22:26,12/12/2024,"10,457,752.99"
ZAFA-00029,TRANSFER FROM ARABIAN TRADING SUPPLIES ARABIAN TRADING SUPPLIES STAFF SALARY,NONREF,Transfer,11/12/2024,"4,968.00",,20:06,11/12/2024,"10,156,267.99"
583771M01GHG,ALMOUWASAT JUBAIL TFR+,INV. SETL DEC'24,Transfer,11/12/2024,"73,498.80",,16:51,11/12/2024,"10,151,299.99"
157471J0010S,UNITED CARTON INDUSTRIES TFR+,PAYMENT INVOICE,Transfer,11/12/2024,"31,491.60",,16:10,11/12/2024,"10,077,801.19"
EBCP-07651,FROM HEALTHCARE EXCHANGE CINV240901186649 Salam CINV240901186649,NONREF,Transfer,11/12/2024,"54,826.43",,16:07,11/12/2024,"10,046,309.59"
200GBMS243460638,"MOHD Y NAGHI MOTR(R) Others,FULL PAYMENT AS P TFR+ 7 INVOICES GULF INTERNATIONAL BANK BSC RIYADH EX Rate : SAR 1.0000000 SA1990000000020000004534",NONREF,Transfer,11/12/2024,"257,079.66",,15:05,11/12/2024,"9,991,483.16"
9005B8CL30P9,FLY NAS SOLE PROPRIETORS TFR+ 1163348240223174 BRT,1163348,Transfer,11/12/2024,"474,035.87",,15:00,11/12/2024,"9,734,403.50"
7.89083E+15,TAQA WELL SERVICES COMPA TFR+,22512024,Transfer,11/12/2024,"153,904.50",,14:22,11/12/2024,"9,260,367.63"
218771M01L1T,RIYADH NAJED TFR+,INV 241011257848,Transfer,11/12/2024,"14,527.95",,14:10,11/12/2024,"9,106,463.13"
1604FT24346PK4WP,AHMED HAMED ALGOSAIBI AND BROS CO. TFR+ SETTLEMENT OF BILL ALINMA BANK ALINMA BANK EX Rate : SAR 1.0000000 SA8605000068200106555000 TRF FROM:SAUDI ARABIA,NONREF,Transfer,11/12/2024,"41,400.00",,13:47,11/12/2024,"9,091,935.18"
627871L00BT9,SELA COMPANY TFR+,5/12/2024,Transfer,11/12/2024,"14,242.27",,13:36,11/12/2024,"9,050,535.18"
1604FT24346S1M6J,ALMOHAMADIAH UNITED COMPANY ALMOHAMADIAH UNITED COMP 23173391164833100 TFR+ رنت متاخره على ميلان SETTLEMENT OF BILL ALINMA BANK ALINMA BANK,NONREF,Transfer,11/12/2024,"23,399.00",,13:32,11/12/2024,"9,036,292.91"
YRTI-16794,LP IPSP2400L2EQ7 AMSA HOSPITALITY CO SA7130400108095375530031 Arab National Bank RIYADH 20241211SAARNBARNB1B30211220936399 11DEC24 12:20:43,NONREF,Transfer,11/12/2024,"3,724.79",,12:20,11/12/2024,"9,012,893.91"
EPHR98124346KD8S,SECOND COAST HOTEL COMPANY TFR+ BANQUE SAUDI FRANSI HEAD OFFICE RIYADH EX Rate : SAR 1.0000000 SA5655000000097891500228 TRF FROM:SAUDI ARABIA 3559 32415,NONREF,Transfer,11/12/2024,"48,300.00",,10:19,11/12/2024,"9,009,169.12"
NCBK82424346ALBI,ركة الدواء للخدمات الطبية مساهمة م TFR+ Service/Utility Bills NATIONAL COMMERCIAL BANK NATIONAL COMMERCIAL BANK EX Rate : SAR 1.0000000 05154747000910 TRF FROM:SAUDI ARABIA,NONREF,Transfer,11/12/2024,"277,518.00",,10:00,11/12/2024,"8,960,869.12"
947683450951A55Y,ركة أن أو في العربية السعودية المح في العربية السعودية المح Invoices INV241131281960 TFR+ Invoices INV241131283200 Invoices INV241131284029 RIYAD BANK HEAD OFFICE RIYADH,NONREF,Transfer,11/12/2024,"71,300.00",,9:33,11/12/2024,"8,683,351.12"
YRTI-10581,LP IPSP2400L221C التجارية شركة شخص واحد SA6305000068201226285002 Alinma bank RIYADH 20241211SAINMAINMA6BXXX10931103680 11DEC24 09:31:19,NONREF,Transfer,11/12/2024,"1,476.60",,9:31,11/12/2024,"8,612,051.12"
9002KAKN6D6L,SAUDI COMPANY FOR ARTIFI TFR+,830,Transfer,11/12/2024,"583,645.71",,9:31,11/12/2024,"8,610,574.52"
RIBLRETN-0648910,LP CPMN2WJORIRN /DIFF/SABBREM24345004K,RIBLRETN-0648910,Transfer,11/12/2024,707.25,,9:22,11/12/2024,"8,026,928.81"
LP CPMN2WPZ0IRN,"CHARGES SAR 7.00 742971L00J7L CORP OPS DIV RIYADH TOTAL VAT SAR1,05 ON CHARGE AMOUNT SAR7,",MANULA 4357740,Charges,11/12/2024,,-8.05,1:14,11/12/2024,"8,026,221.56"
LP CPMN2WPZ0IRN,FAISL MOHAMMED A ALKHATTAF 742971L00J7L BANQUE SAUDI FRANSI CORP OPS DIV RIYADH EX Rate : SAR 1.0000000 BANQUE SAUDI FRANSI TRF TO:SAUDI ARABIA,MANULA 4357740,Transfer,11/12/2024,,"-27,000.00",1:14,11/12/2024,"8,026,229.61"
3.81247E+14,AL WAFI ALTAKAMUL TFR+,4.19551E+15,Transfer,11/12/2024,"15,971.20",,1:13,11/12/2024,"8,053,229.61"
6.42659E+15,MSD KSA GMBH COMPANY TFR+,739024,Transfer,11/12/2024,"74,720.10",,22:52,11/12/2024,"8,037,258.41"
BTPF-00006,ITC SITE CENTERAL REGION 002 20000006015 SADAD:5656910149,ELECT Nov.24,Transfer,11/12/2024,,"-324,346.84",22:51,11/12/2024,"7,962,538.31"
BTPD-00006,3000472438241010 020 3000472438241010 SADAD:5656912419,609578,Transfer,11/12/2024,,"-497,838.04",22:51,11/12/2024,"8,286,885.15"
BTPB-00006,30087822014 002 30087822014 SADAD:5656912387,ELECT Nov.24,Transfer,11/12/2024,,-939.46,22:51,11/12/2024,"8,784,723.19"
BTPA-00006,ITC OFFICE EASTERN REGIO 002 20000495026 SADAD:5656912373,ELECT Nov.24,Transfer,11/12/2024,,"-121,424.04",22:51,11/12/2024,"8,785,662.65"
BTPZ-00006,30079943454 002 30079943454 SADAD:5656910087,ELECT Nov.24,Transfer,11/12/2024,,-51.92,22:51,11/12/2024,"8,907,086.69"
BTPY-00005,ITC SITES AT MEDINA REGI 002 20000086301 SADAD:5656912304,ELECT Nov.24,Transfer,11/12/2024,,"-25,810.43",22:51,11/12/2024,"8,907,138.61"
BTPX-00005,JEDDAH CLS - ELEC BILL 002 20000090126 SADAD:5656910053,ELECT Nov.24,Transfer,11/12/2024,,"-99,198.10",22:51,11/12/2024,"8,932,949.04"
9001B5NCB2TL,ALMOUWASAT ALRIYADH TFR+ ALL DUES,V.PYM 8165,Transfer,11/12/2024,"121,798.80",,22:22,11/12/2024,"9,032,147.14"
YRTI-35030,LP IPSP2400L0SYU LAMASAT COMPANI SA7520000001688777889940 Riyad Bank RIYADH 20241210SARIBLRIBL6BTMS11727274849 10DEC24 17:27:19,NONREF,Transfer,10/12/2024,"1,190.25",,17:27,10/12/2024,"8,910,348.34"
6.75524E+15,LARSEN TOUBRO ARABIA CO TFR+ 8400-4840104605-2024,840022547S306521,Transfer,10/12/2024,"13,800.00",,16:01,10/12/2024,"8,909,158.09"
YRTI-30321,LP IPSP2400L0JQ9 ركة فتحي المحتسب للتجاره SA2680000101608010690608 Alrajhi Bank RIYADH 20241210SARJHIRJHI6BOPF11555498748 10DEC24 15:55:34,NONREF,Transfer,10/12/2024,"15,750.00",,15:55,10/12/2024,"8,895,358.09"
YRTI-30220,LP IPSP2400L0JAX SAFE DECISION CO SA9820000002600755909940 Riyad Bank RIYADH 20241210SARIBLRIBL6BTMS11553227063 10DEC24 15:53:55,NONREF,Transfer,10/12/2024,"1,671.53",,15:53,10/12/2024,"8,879,608.09"
YRTI-28596,LP IPSP2400L0GN1 MUNIF AMER ABDULLAH ALNA SA9080000577608010026329 Alrajhi Bank RIYADH 20241210SARJHIRJHI6BOPF11518441248 10DEC24 15:19:03,NONREF,Transfer,10/12/2024,"10,000.00",,15:19,10/12/2024,"8,877,936.56"
556371L00VPV,AL BARRAK SHIPPING AGENC TFR+,A/C 16207,Transfer,10/12/2024,"24,150.00",,15:04,10/12/2024,"8,867,936.56"
NCBK6592434506ZR,ركة كات انترناشنال المحدودة شركة - ترناشنال المحدودة شركة شراء بضاعة TFR+ NATIONAL COMMERCIAL BANK NATIONAL COMMERCIAL BANK EX Rate : SAR 1.0000000 65900000246500,NONREF,Transfer,10/12/2024,"541,218.75",,14:30,10/12/2024,"8,843,786.56"
269371L000NK,CHEDID + ASSOCIATES TFR+,ITC Q4 INVOICES,Transfer,10/12/2024,"88,678.80",,14:24,10/12/2024,"8,302,567.81"
YRTI-24360,LP IPSP2400L02GB مد باقر بن علوي الخضراوي SA4810000032400000776104 Saudi National Bank JEDDAH 20241210SANCBKNCBK2B82811352511505 10DEC24 13:53:08,NONREF,Transfer,10/12/2024,"3,159.00",,13:53,10/12/2024,"8,213,889.01"
EPHR98124345JAUK,UMMAHAT ISLAND OPERATION COMPANY I UMMAHAT ISLAND OPERATION INV240821224692U Jul T S TFR+ BANQUE SAUDI FRANSI HEAD OFFICE RIYADH EX Rate : SAR 1.0000000 SA82550000000R0595000169,NONREF,Transfer,10/12/2024,"103,500.00",,13:47,10/12/2024,"8,210,730.01"
9019Z8FNCWMH,PHILIPS HEALTHCARE SA CO TFR+,2000002674-2675,Transfer,10/12/2024,"3,674.25",,12:28,10/12/2024,"8,107,230.01"
NCBK501243456099,Saudi National Bank Operating Expenses INV N TFR+ 648 CC 0546 Group Technology 112070 NATIONAL COMMERCIAL BANK NATIONAL COMMERCIAL BANK EX Rate : SAR 1.0000000 50147351000100 TRF FROM:SAUDI ARABIA,NONREF,Transfer,10/12/2024,"278,056.07",,11:55,10/12/2024,"8,103,555.76"
NCBK82424345ANKS,S.B. OF ENGI. ENPPI مصاريف تشغيل TFR+ فواتير خدمات NATIONAL COMMERCIAL BANK NATIONAL COMMERCIAL BANK EX Rate : SAR 1.0000000 95400005556907 TRF FROM:SAUDI ARABIA,NONREF,Transfer,10/12/2024,"61,582.50",,11:31,10/12/2024,"7,825,499.69"
578271L00G2Z,SAUDI EBREEZ COMPANY FOR TFR+ INV INV241011250658 INV241011243686 INV241011242578,INV OCT-DEC'24,Transfer,10/12/2024,"27,303.30",,10:56,10/12/2024,"7,763,917.19"
V241210101934619,401024601638237 :تنفيذ قضااى 401024601638237 :ذ قضااى /99/16168427 TFR+ AL RAJHI BANKING AND INV T CORP HEAD OFFICE RIYADH EX Rate : SAR 1.0000000,NONREF,Transfer,10/12/2024,"51,831.21",,10:42,10/12/2024,"7,736,613.89"
V241210102845630,401014602225871 :تنفيذ قضااى 401014602225871 :ذ قضااى /99/16169828 TFR+ AL RAJHI BANKING AND INV T CORP HEAD OFFICE RIYADH EX Rate : SAR 1.0000000,NONREF,Transfer,10/12/2024,"1,500.00",,10:42,10/12/2024,"7,684,782.68"
4.03324E+14,Al Mosafer TravTour(MTC) TFR+ YMENT AL RAJHI BANKING AND INV T CORP HEAD OFFICE RIYADH EX Rate : SAR 1.0000000 SA1580000296608010916669,NONREF,Transfer,10/12/2024,"38,640.00",,9:44,10/12/2024,"7,683,282.68"
R132633596EBPLUS,ALINMA MEDICAL SERVICES COMPANIES FOR OTHER PURP TFR+ سداد دفعه من الحساب ARAB NATIONAL BANK RIYADH BRANCH EX Rate : SAR 1.0000000 0108050581580137 TRF FROM:SAUDI ARABIA,NONREF,Transfer,10/12/2024,"37,563.60",,9:38,10/12/2024,"7,644,642.68"
010141209H776064,Financial planning and control Financial planning and c Invoice.INV241111267698 TFR+ SAUDI INVESTMENT BANK RIYADH EX Rate : SAR 1.0000000 0101 804640 888,NONREF,Transfer,10/12/2024,"10,350.00",,9:30,10/12/2024,"7,607,079.08"
200GTSA243440128,"SAUDI INT.TRD.CO.LTD Invoice Settlement,CINV2 TFR+ INV241011250063 AND INV24101124390 7 GULF INTERNATIONAL BANK BSC RIYADH EX Rate : SAR 1.0000000",NONREF,Transfer,10/12/2024,"45,257.10",,9:09,10/12/2024,"7,596,729.08"
NCBK82424344AMLB,شركة سولدير قرطبة TFR+ Service/Utility Bills NATIONAL COMMERCIAL BANK NATIONAL COMMERCIAL BANK EX Rate : SAR 1.0000000 62518063000300 TRF FROM:SAUDI ARABIA,NONREF,Transfer,10/12/2024,"313,270.04",,8:08,10/12/2024,"7,551,471.98"
TT CPMN0J9JAIRNN,"CHARGES SAR 130.00 524371J01OL3 TOTAL VAT SAR19,5 ON CHARGE AMOUNT SAR130,",609265,Charges,10/12/2024,,-149.5,6:00,10/12/2024,"7,238,201.94"
TT CPMN0J9JAIRNN,RELIANCE- FLAG TELECOM IRELAND DAC 524371J01OL3 EX Rate : SAR 3.7550000 BARCLAYS BANK IRELAND LT D TRF TO:IRELAND,609265,Transfer,10/12/2024,,"-1,230,419.63",6:00,10/12/2024,"7,238,351.44"
052771C005QY,"JGC GULF INTERNATIONAL TFR+ INV2410331248731, INV241031249741,INV241031242490, INV241031251135, INV0044234",RFP-34071/2/4/5,Transfer,10/12/2024,"423,885.51",,1:32,10/12/2024,"8,468,771.07"
LP CPMN2WJOWIRN,"CHARGES SAR 7.00 90144BGU1FGL HEAD OFFICE RIYADH TOTAL VAT SAR1,05 ON CHARGE AMOUNT SAR7,",RFND181803510,Charges,10/12/2024,,-8.05,1:26,10/12/2024,"8,044,885.56"
LP CPMN2WJOWIRN,SAUD ALOSAIMI 90144BGU1FGL RIYAD BANK HEAD OFFICE RIYADH EX Rate : SAR 1.0000000 RIYAD BANK TRF TO:SAUDI ARABIA,RFND181803510,Transfer,10/12/2024,,-230,1:26,10/12/2024,"8,044,893.61"
LP CPMN2WJOUIRN,"CHARGES SAR 7.00 9011G8HOGRR9 KING ABDUL AZIZ ST ALHOB AR TOTAL VAT SAR1,05 ON CHARGE AMOUNT SAR7,",FTTH09517458,Charges,10/12/2024,,-8.05,1:26,10/12/2024,"8,045,123.61"
LP CPMN2WJOUIRN,RASICKRAHMAN MUSTABA 9011G8HOGRR9 ARAB NATIONAL BANK KING ABDUL AZIZ ST ALHOB AR EX Rate : SAR 1.0000000 ARAB NATIONAL BANK TRF TO:SAUDI ARABIA,FTTH09517458,Transfer,10/12/2024,,-870,1:26,10/12/2024,"8,045,131.66"
LP CPMN2WJOTIRN,"CHARGES SAR 7.00 901344UVLMRP ALINMA BANK TOTAL VAT SAR1,05 ON CHARGE AMOUNT SAR7,",FTTH09479397,Charges,10/12/2024,,-8.05,1:26,10/12/2024,"8,046,001.66"
LP CPMN2WJOTIRN,KHALED ALSUWAIYEL 901344UVLMRP ALINMA BANK ALINMA BANK EX Rate : SAR 1.0000000 ALINMA BANK TRF TO:SAUDI ARABIA,FTTH09479397,Transfer,10/12/2024,,-870,1:26,10/12/2024,"8,046,009.71"
LP CPMN2WJOSIRN,"CHARGES SAR 7.00 901217BHQHOL THE NATIONAL COMMERCIAL BANK TOTAL VAT SAR1,05 ON CHARGE AMOUNT SAR7,",FTTH09680355,Charges,10/12/2024,,-8.05,1:26,10/12/2024,"8,046,879.71"
LP CPMN2WJOSIRN,ATIF JAVED 901217BHQHOL NATIONAL COMMERCIAL BANK THE NATIONAL COMMERCIAL BANK EX Rate : SAR 1.0000000 NATIONAL COMMERCIAL BANK TRF TO:SAUDI ARABIA,FTTH09680355,Transfer,10/12/2024,,-290,1:26,10/12/2024,"8,046,887.76"
LP CPMN2WJORIRN,"CHARGES SAR 7.00 9004GBH4GRS5 HEAD OFFICE RIYADH TOTAL VAT SAR1,05 ON CHARGE AMOUNT SAR7,",FTTH08177966,Charges,10/12/2024,,-8.05,1:26,10/12/2024,"8,047,177.76"
LP CPMN2WJORIRN,FADI MOHAMMED 9004GBH4GRS5 RIYAD BANK HEAD OFFICE RIYADH EX Rate : SAR 1.0000000 RIYAD BANK TRF TO:SAUDI ARABIA,FTTH08177966,Transfer,10/12/2024,,-707.25,1:26,10/12/2024,"8,047,185.81"
LP CPMN2WJOQIRN,"CHARGES SAR 7.00 901072M8SYH1 T CORP BR 161 JEDDAH TOTAL VAT SAR1,05 ON CHARGE AMOUNT SAR7,",FTTH09485475,Charges,10/12/2024,,-8.05,1:26,10/12/2024,"8,047,893.06"
LP CPMN2WJOQIRN,KHALID ALKHUDAIRY 901072M8SYH1 AL RAJHI BANKING AND INV T CORP BR 161 JEDDAH EX Rate : SAR 1.0000000 AL RAJHI BANKING AND INV T CORP,FTTH09485475,Transfer,10/12/2024,,"-1,080.00",1:26,10/12/2024,"8,047,901.11"
LP CPMN2WJOPIRN,"CHARGES SAR 7.00 9009D7T007WL T CORP BR 161 JEDDAH TOTAL VAT SAR1,05 ON CHARGE AMOUNT SAR7,",FTTH09472015,Charges,10/12/2024,,-8.05,1:26,10/12/2024,"8,048,981.11"
LP CPMN2WJOPIRN,BELAL AREF HUSSEIN ALRTAIMAT 9009D7T007WL AL RAJHI BANKING AND INV T CORP BR 161 JEDDAH EX Rate : SAR 1.0000000 AL RAJHI BANKING AND INV T CORP,FTTH09472015,Transfer,10/12/2024,,-997.25,1:26,10/12/2024,"8,048,989.16"
LP CPMN2WJOOIRN,"CHARGES SAR 7.00 9003I4LUHTT1 T CORP BR 161 JEDDAH TOTAL VAT SAR1,05 ON CHARGE AMOUNT SAR7,",FTTH09486861,Charges,10/12/2024,,-8.05,1:26,10/12/2024,"8,049,986.41"
LP CPMN2WJOOIRN,KHALID ALKHUDAIRY 9003I4LUHTT1 AL RAJHI BANKING AND INV T CORP BR 161 JEDDAH EX Rate : SAR 1.0000000 AL RAJHI BANKING AND INV T CORP,FTTH09486861,Transfer,10/12/2024,,"-1,080.00",1:26,10/12/2024,"8,049,994.46"
LP CPMN2WJONIRN,"CHARGES SAR 7.00 9008Q4FOBQPX T CORP BR 161 JEDDAH TOTAL VAT SAR1,05 ON CHARGE AMOUNT SAR7,",RFND181802527,Charges,10/12/2024,,-8.05,1:26,10/12/2024,"8,051,074.46"
LP CPMN2WJONIRN,MD HOSSAIN 9008Q4FOBQPX AL RAJHI BANKING AND INV T CORP BR 161 JEDDAH EX Rate : SAR 1.0000000 AL RAJHI BANKING AND INV T CORP,RFND181802527,Transfer,10/12/2024,,-199,1:26,10/12/2024,"8,051,082.51"
LP CPMN2WJOMIRN,"CHARGES SAR 7.00 900528LPNDPH ALINMA BANK TOTAL VAT SAR1,05 ON CHARGE AMOUNT SAR7,",FTTH09523579,Charges,10/12/2024,,-8.05,1:26,10/12/2024,"8,051,281.51"
LP CPMN2WJOMIRN,KHLOUD ALSARAAN 900528LPNDPH ALINMA BANK ALINMA BANK EX Rate : SAR 1.0000000 ALINMA BANK TRF TO:SAUDI ARABIA,FTTH09523579,Transfer,10/12/2024,,-400,1:26,10/12/2024,"8,051,289.56"
LP CPMN2WJOLIRN,"CHARGES SAR 7.00 90027BF5N2G5 THE NATIONAL COMMERCIAL BANK TOTAL VAT SAR1,05 ON CHARGE AMOUNT SAR7,",FTTH09670834,Charges,10/12/2024,,-8.05,1:26,10/12/2024,"8,051,689.56"
LP CPMN2WJOLIRN,AHMAD ALKURDI 90027BF5N2G5 NATIONAL COMMERCIAL BANK THE NATIONAL COMMERCIAL BANK EX Rate : SAR 1.0000000 NATIONAL COMMERCIAL BANK TRF TO:SAUDI ARABIA,FTTH09670834,Transfer,10/12/2024,,-400,1:26,10/12/2024,"8,051,697.61"
LP CPMN2WJOKIRN,"CHARGES SAR 7.00 9001L6NUQ8MD T CORP BR 161 JEDDAH TOTAL VAT SAR1,05 ON CHARGE AMOUNT SAR7,",FTTB06991076,Charges,10/12/2024,,-8.05,1:26,10/12/2024,"8,052,097.61"
LP CPMN2WJOKIRN,ONE HUNDRED AND EIGHTY DEGREES 9001L6NUQ8MD AL RAJHI BANKING AND INV T CORP BR 161 JEDDAH EX Rate : SAR 1.0000000 AL RAJHI BANKING AND INV T CORP,FTTB06991076,Transfer,10/12/2024,,-299,1:26,10/12/2024,"8,052,105.66"
LP CPMN2WJOJIRN,"CHARGES SAR 7.00 895071J00LDX RIYADH TOTAL VAT SAR1,05 ON CHARGE AMOUNT SAR7,",609292,Charges,10/12/2024,,-8.05,1:26,10/12/2024,"8,052,404.66"
LP CPMN2WJOJIRN,RESTART CO. LTD 895071J00LDX /RFB/ITC INVOICE PAYMENT SAUDI INVESTMENT BANK RIYADH EX Rate : SAR 1.0000000 SAUDI INVESTMENT BANK TRF TO:SAUDI ARABIA,609292,Transfer,10/12/2024,,"-1,035,803.81",1:26,10/12/2024,"8,052,412.71"
LP CPMN2WJOIIRN,"CHARGES SAR 7.00 464571J00KRF HEAD OFFICE RIYADH TOTAL VAT SAR1,05 ON CHARGE AMOUNT SAR7,",609172,Charges,10/12/2024,,-8.05,1:26,10/12/2024,"9,088,216.52"
LP CPMN2WJOIIRN,MOBILE BUSINESS COMPANY LLC 464571J00KRF RIYAD BANK HEAD OFFICE RIYADH EX Rate : SAR 1.0000000 RIYAD BANK TRF TO:SAUDI ARABIA,609172,Transfer,10/12/2024,,"-2,334,445.20",1:26,10/12/2024,"9,088,224.57"
LP CPMN2WJOHIRN,"CHARGES SAR 7.00 588871K013D4 CORP OPS DIV RIYADH TOTAL VAT SAR1,05 ON CHARGE AMOUNT SAR7,",609419,Charges,10/12/2024,,-8.05,1:26,10/12/2024,"11,422,669.77"
LP CPMN2WJOHIRN,AMJAD TRUST GENERAL CONTRACTING EST 588871K013D4 BANQUE SAUDI FRANSI CORP OPS DIV RIYADH EX Rate : SAR 1.0000000 BANQUE SAUDI FRANSI TRF TO:SAUDI ARABIA,609419,Transfer,10/12/2024,,"-350,000.00",1:26,10/12/2024,"11,422,677.82"
LP CPMN2WJOGIRN,"CHARGES SAR 7.00 460771J00IVV RIYADH TOTAL VAT SAR1,05 ON CHARGE AMOUNT SAR7,",609551,Charges,10/12/2024,,-8.05,1:26,10/12/2024,"11,772,677.82"
LP CPMN2WJOGIRN,MIDDLE EAST AND AFRICA GROUP TECH. 460771J00IVV /RFB/ITC INVOICE PAYMENT SAUDI INVESTMENT BANK RIYADH EX Rate : SAR 1.0000000 SAUDI INVESTMENT BANK TRF TO:SAUDI ARABIA,609551,Transfer,10/12/2024,,"-436,875.80",1:26,10/12/2024,"11,772,685.87"
LP CPMN2WJOEIRN,"CHARGES SAR 7.00 422271J00K9M RIYADH TOTAL VAT SAR1,05 ON CHARGE AMOUNT SAR7,",12589,Charges,10/12/2024,,-8.05,1:26,10/12/2024,"12,209,561.67"
LP CPMN2WJOEIRN,SPECIALIZED TECHNOLOGIES CO 422271J00K9M ITC INVOICE PAYMENT SAUDI INVESTMENT BANK RIYADH EX Rate : SAR 1.0000000 SAUDI INVESTMENT BANK TRF TO:SAUDI ARABIA,12589,Transfer,10/12/2024,,"-1,092,500.00",1:26,10/12/2024,"12,209,569.72"
LP CPMN2WJODIRN,"CHARGES SAR 7.00 294271J00JNC BSC RIYADH TOTAL VAT SAR1,05 ON CHARGE AMOUNT SAR7,",609437,Charges,10/12/2024,,-8.05,1:26,10/12/2024,"13,302,069.72"
LP CPMN2WJODIRN,SAUDI EMIRCOM COMPANY 294271J00JNC /RFB/ITC INVOICE PAYMENT GULF INTERNATIONAL BANK BSC RIYADH EX Rate : SAR 1.0000000 GULF INTERNATIONAL BANK,609437,Transfer,10/12/2024,,"-3,343,060.10",1:26,10/12/2024,"13,302,077.77"
LP CPMN2WJOCIRN,"CHARGES SAR 7.00 193671J00NDM JPMorgan Chase Bank Nat Association TOTAL VAT SAR1,05 ON CHARGE AMOUNT SAR7,",609549,Charges,10/12/2024,,-8.05,1:26,10/12/2024,"16,645,137.87"
LP CPMN2WJOCIRN,APPLE SAUDI ARABIA LLC 193671J00NDM JPMORGAN CHASE BANK NA JPMorgan Chase Bank Nat Association EX Rate : SAR 1.0000000,609549,Transfer,10/12/2024,,"-493,925.00",1:26,10/12/2024,"16,645,145.92"
LP CPMN2WJOAIRN,"CHARGES SAR 7.00 022571J00N08 HEAD OFFICE RIYADH TOTAL VAT SAR1,05 ON CHARGE AMOUNT SAR7,",609408,Charges,10/12/2024,,-8.05,1:26,10/12/2024,"17,139,070.92"
LP CPMN2WJOAIRN,FLE SHIELD INFORATION 022571J00N08 RIYAD BANK HEAD OFFICE RIYADH EX Rate : SAR 1.0000000 RIYAD BANK TRF TO:SAUDI ARABIA,609408,Transfer,10/12/2024,,"-1,000,000.00",1:26,10/12/2024,"17,139,078.97"
3.25862E+15,ALNAHDI CARE COMPANY LIM TFR+,119139,Transfer,10/12/2024,"88,927.20",,22:30,10/12/2024,"18,139,078.97"
EBBD-00529,FROM HILTON GARDEN INN Apr to Jun 24 INVESTMENT PURPOSE,NONREF,Transfer,9/12/2024,"6,348.00",,21:22,9/12/2024,"18,050,151.77"
600171K01MR3,ALSADHAN KHALED 011-071578-001,MANUAL 4357697,Transfer,9/12/2024,,"-14,477.48",18:26,9/12/2024,"18,043,803.77"
490171K014HO,CHINA SAUDI COMMUNICATI 011-280880-001 /RFB/ITC INVOICE PAYMENT,609261,Transfer,9/12/2024,,"-3,323,308.28",18:26,9/12/2024,"18,058,281.25"
BTPJ-00558,648220855 060 648220855 SADAD:5653998292,GOSI Nov.24,Transfer,9/12/2024,,"-121,093.14",17:59,9/12/2024,"21,381,589.53"
BTPI-00571,ITC GOSI 060 500936371 SADAD:5654003837,GOSI Nov.24,Transfer,9/12/2024,,"-1,649,594.96",17:59,9/12/2024,"21,502,682.67"
BTPH-00560,604950104 060 604950104 SADAD:5653997789,GOSI Nov.24,Transfer,9/12/2024,,"-101,237.56",17:59,9/12/2024,"23,152,277.63"
BTPC-00566,21031644195 021 21031644195 SADAD:5653996230,list 109,Transfer,9/12/2024,,-300,17:57,9/12/2024,"23,253,515.19"
BTPA-00560,Mobily bill 005 1000115518597426 SADAD:5653994606,609522,Transfer,9/12/2024,,"-24,150.00",17:57,9/12/2024,"23,253,815.19"
439171J00JAJ,ADVANCED CONDITIONERS CO 011-398112-001 /RFB/ITC INVOICE PAYMENT,609340,Transfer,9/12/2024,,"-19,033.65",17:55,9/12/2024,"23,277,965.19"
9007H54IWSV9,SYED BASEER 156-112914-001,FTTH08150674,Transfer,9/12/2024,,-290,17:55,9/12/2024,"23,296,998.84"
9006B2SE5AJP,GATBONTON WILLIAM 042-844340-150,FTTH09485061,Transfer,9/12/2024,,-290,17:55,9/12/2024,"23,297,288.84"
732371J01R4U,ALJUF - A/P TFR+,1.68724E+12,Transfer,9/12/2024,"63,055.24",,16:55,9/12/2024,"23,297,578.84"
YRTI-27850,LP IPSP2400KX8G7 ALNAFA FOR FOOD CO LTD SA7820000001010008689940 Riyad Bank RIYADH 20241209SARIBLRIBL6BTMS11634750411 09DEC24 16:35:12,NONREF,Transfer,9/12/2024,"17,503.00",,16:35,9/12/2024,"23,234,523.60"
GSCR-00087,DC ADVISING - AMENDMENT CHARGE E069564 -00,NONREF,Transfer,9/12/2024,,-287.5,16:28,9/12/2024,"23,217,020.60"
EBBD-09653,FROM WISSAM ALRAHDEN HOT بلغ النهائي وانهاء العقد تصفية المب,NONREF,Transfer,9/12/2024,"23,575.00",,15:16,9/12/2024,"23,217,308.10"
NCBK6592434406Z3,لشركة السعودية لمعدات الديزل المح TFR+ NATIONAL COMMERCIAL BANK NATIONAL COMMERCIAL BANK EX Rate : SAR 1.0000000 05512840040110 TRF FROM:SAUDI ARABIA دودة ش ركة شخص واحد,NONREF,Transfer,9/12/2024,"41,400.00",,14:59,9/12/2024,"23,193,733.10"
P132593841EBPLUS,UNITED COMPOUNDING INDUSTRIAL CO UNITED COMPOUNDING INDUS COMPANIES FOR OTHER PURP TFR+ UCIC PAYMENT ARAB NATIONAL BANK RIYADH BRANCH EX Rate : SAR 1.0000000,NONREF,Transfer,9/12/2024,"34,482.75",,14:52,9/12/2024,"23,152,333.10"
NCBK82424344ASJL,شركة ايوان الضيافة لتشغيل الفنادق TFR+ فواتير خدمات NATIONAL COMMERCIAL BANK NATIONAL COMMERCIAL BANK EX Rate : SAR 1.0000000 65900000637103 TRF FROM:SAUDI ARABIA,NONREF,Transfer,9/12/2024,"142,594.71",,14:41,9/12/2024,"23,117,850.35"
150171J01DE6,MITSUBISHI ALKHOBAR TFR+,INTERNET,Transfer,9/12/2024,"8,050.00",,14:28,9/12/2024,"22,975,255.64"
NCBK82424344ASSL,ركه الدريس للصناعه والتجاره اليتكو للصناعه والتجاره اليتكو Operating Expenses TFR+ Service/Utility Bills NATIONAL COMMERCIAL BANK NATIONAL COMMERCIAL BANK EX Rate : SAR 1.0000000,NONREF,Transfer,9/12/2024,"7,981.00",,14:25,9/12/2024,"22,967,205.64"
ECOF41209H000410,UNI DENTS CLINIC مصاريف تشغيلية TFR+الاتصالات المتكاملة تسديد وتصفية كBANK AL-JAZIRA HEAD OFFICE JEDDAHEX Rate : SAR 1.0000000 SA3860100010495022891001,NONREF,Transfer,9/12/2024,"29,507.00",,12:22,9/12/2024,"22,959,224.64"
010141209H775571,ABDULRAHMAN ABDULLAH ALMUSA SONS CO ABDULRAHMAN ABDULLAH ALM سداد رسوم اشتراك انترنت TFR+ 08082024 6 2409112 240711190923 الشركة عن تاريخ PV 2024 12 00012 MJ 0015197 SAUDI INVESTMENT BANK,NONREF,Transfer,9/12/2024,"29,521.61",,12:09,9/12/2024,"22,929,717.64"
5.00003E+11,SAUDI AIR NAVIGATION SERVICES SAUDI AIR NAVIGATION SER INTB0295889105770722117E TFR+ AL RAJHI BANKING AND INV T CORP HEAD OFFICE RIYADH EX Rate : SAR 1.0000000,NONREF,Transfer,9/12/2024,"119,521.80",,11:11,9/12/2024,"22,900,196.03"
5.00003E+11,EMIRATES ADVANTAGE TRANSPORT AND ST EMIRATES ADVANTAGE TRANS INTB0175737426780012343E TFR+ AL RAJHI BANKING AND INV T CORP HEAD OFFICE RIYADH EX Rate : SAR 1.0000000,NONREF,Transfer,9/12/2024,"76,966.96",,10:41,9/12/2024,"22,780,674.23"
EPHR98124344HCBD,NAMARIQ ARABIAN SERVICES COMPANY TFR+ BANQUE SAUDI FRANSI HEAD OFFICE RIYADH EX Rate : SAR 1.0000000 SA5655000000097283100223 TRF FROM:SAUDI ARABIA 7051 23525,NONREF,Transfer,9/12/2024,"101,194.07",,10:17,9/12/2024,"22,703,707.27"
P132525961EBPLUS,AMSA HOSPITALITY CO TFR+ INV 240711189083 + 240711191560 + 241011242159 + 241011248882 + 0 + 40880 + 41673 + 44186 Telephone ARAB NATIONAL BANK RIYADH BRANCH EX Rate : SAR 1.0000000,NONREF,Transfer,9/12/2024,"235,128.94",,10:11,9/12/2024,"22,602,513.20"
200GTSA243430044,MOHD Y NAGHI MOTR(R) TFR+ GULF INTERNATIONAL BANK BSC RIYADH EX Rate : SAR 1.0000000 SA3590000000020000004537 TRF FROM:SAUDI ARABIA,NONREF,Transfer,9/12/2024,"509,312.00",,10:09,9/12/2024,"22,367,384.26"
FT24343856676660,EYE CARE COMPANY SETTLEMENT OF BILLS TFR+ 585 24عام 6و 5و 4سداد شهر BANK AL BILAD BANK AL BILAD EX Rate : SAR 1.0000000 SA6115000567133000050041 TRF FROM:SAUDI ARABIA,NONREF,Transfer,9/12/2024,"9,841.28",,10:05,9/12/2024,"21,858,072.26"
5.00003E+11,MANDARIN ORIENTAL AL FAISALIAH HOTE MANDARIN ORIENTAL AL FAI INTB0241914135041773703E TFR+ AL RAJHI BANKING AND INV T CORP HEAD OFFICE RIYADH EX Rate : SAR 1.0000000,NONREF,Transfer,9/12/2024,"340,356.30",,9:40,9/12/2024,"21,848,230.98"
NCBK82424343BBEF,S.B. OF ENGI. ENPPI مصاريف تشغيل TFR+ فواتير خدمات NATIONAL COMMERCIAL BANK NATIONAL COMMERCIAL BANK EX Rate : SAR 1.0000000 95400005556907 TRF FROM:SAUDI ARABIA,NONREF,Transfer,9/12/2024,"227,700.00",,9:36,9/12/2024,"21,507,874.68"
EPHR98124344HC7J,TECNICAS REUNIDAS SAUDI FOR SERVICE TECNICAS REUNIDAS SAUDI PAY DEC INV241231292783 TFR+ BANQUE SAUDI FRANSI HEAD OFFICE RIYADH EX Rate : SAR 1.0000000 SA5655000000097156701754,NONREF,Transfer,9/12/2024,"56,925.00",,9:25,9/12/2024,"21,280,174.68"
TT CPMN0J7CEIRNN,"CHARGES SAR 130.00 198071G01H4G TOTAL VAT SAR19,5 ON CHARGE AMOUNT SAR130,",609500,Charges,9/12/2024,,-149.5,6:00,9/12/2024,"21,223,249.68"
TT CPMN0J7CEIRNN,TELECOM ITALIA SPARKLE S.P.A 198071G01H4G EX Rate : SAR 3.7550000 DEUTSCHE BANK SPA TRF TO:ITALY,609500,Transfer,9/12/2024,,"-199,071.33",6:00,9/12/2024,"21,223,399.18"
SAUDI ARABIAN OI,2000224039 /INV//CINV241131284425 TFR+,2000224039,Transfer,9/12/2024,"243,963.70",,22:34,9/12/2024,"21,422,470.51"
ZAFA-00047,TRANSFER FROM LOUIS BERGER LOUIS BERGER SUPPLIER PAYMENT INV,NONREF,Transfer,8/12/2024,"6,107.68",,20:08,8/12/2024,"21,178,506.81"
YRTI-90427,LP IPSP2400KTXGR JAWA HUMAN RESOURCES CO SA4080000273608010498426 Alrajhi Bank RIYADH 20241208SARJHIRJHI6BOPF11544492258 08DEC24 15:44:18,NONREF,Transfer,8/12/2024,"13,800.00",,15:44,8/12/2024,"21,172,399.13"
9001X86F4VC5,IBIS YANBU HOTEL (BR) TFR+ SALAM INTERNET,INTERNET PAYMENT,Transfer,8/12/2024,"24,684.75",,15:04,8/12/2024,"21,158,599.13"
2.32683E+15,ؤسسة كأس العالم للرياضات الالكترون لعالم للرياضات الالكترون أخرى / شخصي TFR+ CONTRACT ESP-05-050524 INV2409 RIYAD BANK HEAD OFFICE RIYADH EX Rate : SAR 1.0000000,NONREF,Transfer,8/12/2024,"483,432.32",,14:52,8/12/2024,"21,133,914.38"
010141208H774486,HOTEL CROWN PLAZA ALRAYYAD ALWAHAH HOTEL CROWN PLAZA ALRAYY OCT24 TELL DEC24 TFR+ SAUDI INVESTMENT BANK RIYADH EX Rate : SAR 1.0000000 0101 753654 001,NONREF,Transfer,8/12/2024,"20,700.00",,14:23,8/12/2024,"20,650,482.06"
5.00003E+11,KUN SPORTS COMPANY TFR+ AL RAJHI BANKING AND INV T CORP HEAD OFFICE RIYADH EX Rate : SAR 1.0000000 SA1780000577608010071002 TRF FROM:SAUDI ARABIA,NONREF,Transfer,8/12/2024,"100,000.00",,14:13,8/12/2024,"20,629,782.06"
YRTI-85819,LP IPSP2400KTM9R AHMED MOHAMED SALEH BAES SA5655000000003053908327 Banque Saudi Fransi RIYADH 20241208SABSFRBSFR6BCFT11402056591 08DEC24 14:02:56,NONREF,Transfer,8/12/2024,"6,900.00",,14:02,8/12/2024,"20,529,782.06"
YRTI-83633,LP IPSP2400KTGLT ORBITS COMMUNICATION COM SA6620000001573564379940 Riyad Bank RIYADH 20241208SARIBLRIBL6BTMS11314279057 08DEC24 13:15:05,NONREF,Transfer,8/12/2024,156,,13:15,8/12/2024,"20,522,882.06"
946683430951ZTDQ,ؤسسة حلول الافاق للاتصالات و تقنية الافاق للاتصالات و تقنية Real Estate/Utilities TFR+ سداد فاتورة رقم RIYAD BANK HEAD OFFICE RIYADH EX Rate : SAR 1.0000000,NONREF,Transfer,8/12/2024,"22,356.00",,12:51,8/12/2024,"20,522,726.06"
EPHR98124343H1RF,AHMED MOHAMED SALEH BAESHEN and CO AHMED MOHAMED SALEH BAES Various Invoices Payment TFR+ BANQUE SAUDI FRANSI HEAD OFFICE RIYADH EX Rate : SAR 1.0000000 SA5655000000003053908327,NONREF,Transfer,8/12/2024,"82,505.27",,12:43,8/12/2024,"20,500,370.06"
EBP4-04075,SADAD REFUND SABBSARI6202412051340391 SADAD:45390611 SABBSARI6202412051340391529,NONREF,Transfer,8/12/2024,650,,0:00,8/12/2024,"20,417,864.79"
ECOF41208H000482,INTERNATIONAL HOSPITALS CON CO. LTD INTERNATIONAL HOSPITALS Operational Expenses TFR+ BANK AL-JAZIRA HEAD OFFICE JEDDAH EX Rate : SAR 1.0000000 SA0560000000840283028001,NONREF,Transfer,8/12/2024,"7,935.00",,12:22,8/12/2024,"20,417,214.79"
NCBK82424343AOIC,ركة حمد بن عبدالله بن سليمان المني عبدالله بن سليمان المني مصاريف تشغيل TFR+ فواتير خدمات NATIONAL COMMERCIAL BANK NATIONAL COMMERCIAL BANK EX Rate : SAR 1.0000000,NONREF,Transfer,8/12/2024,"18,030.85",,12:15,8/12/2024,"20,409,279.79"
YRTI-80478,LP IPSP2400KT8R5 AL MURJAN MEDICAL CENTER SA4230400108095589030075 Arab National Bank RIYADH 20241208SAARNBARNB1B60111157968005 08DEC24 11:57:49,NONREF,Transfer,8/12/2024,"15,962.07",,11:57,8/12/2024,"20,391,248.94"
010141207H773373,MOHAMMED SAAD ALBAWARDY AND SONS CO TFR+ California Resort SAUDI INVESTMENT BANK RIYADH EX Rate : SAR 1.0000000 0138 588802 004 TRF FROM:SAUDI ARABIA,NONREF,Transfer,8/12/2024,"85,836.00",,11:45,8/12/2024,"20,375,286.87"
NCBK82424340BAPO,MERIDIEN MAKKAH TFR+ Operational Maintenance NATIONAL COMMERCIAL BANK NATIONAL COMMERCIAL BANK EX Rate : SAR 1.0000000 86300001044305 TRF FROM:SAUDI ARABIA,NONREF,Transfer,8/12/2024,"239,997.57",,11:10,8/12/2024,"20,289,450.87"
200GTSA243400618,MOHD Y NAGHI MOTR(R) TFR+ GULF INTERNATIONAL BANK BSC RIYADH EX Rate : SAR 1.0000000 SA0890000000020000004538 TRF FROM:SAUDI ARABIA,NONREF,Transfer,8/12/2024,"411,889.20",,11:07,8/12/2024,"20,049,453.30"
NCBK82424343AKIK,النقابه العامه للسيارات مصاريف تشغيل TFR+ فواتير خدمات NATIONAL COMMERCIAL BANK NATIONAL COMMERCIAL BANK EX Rate : SAR 1.0000000 01215000000202 TRF FROM:SAUDI ARABIA,NONREF,Transfer,8/12/2024,"53,970.00",,9:46,8/12/2024,"19,637,564.10"
1604FT24340XKQ5J,INFOBIP CO INV241011264297 TFR+ SETTLEMENT OF BILL ALINMA BANK ALINMA BANK EX Rate : SAR 1.0000000 SA6805000068202039931000 TRF FROM:SAUDI ARABIA,NONREF,Transfer,8/12/2024,"79,184.40",,9:42,8/12/2024,"19,583,594.10"
1604FT243402ZQ2V,INFOBIP CO INV241111283911 TFR+ SETTLEMENT OF BILL ALINMA BANK ALINMA BANK EX Rate : SAR 1.0000000 SA6805000068202039931000 TRF FROM:SAUDI ARABIA,NONREF,Transfer,8/12/2024,"79,184.40",,9:40,8/12/2024,"19,504,409.70"
NCBK55724340AKNP,"GLOBEMED Buying Goods TFR+ NATIONAL COMMERCIAL BANK NATIONAL COMMERCIAL BANK EX Rate : SAR 1.0000000 71100006166403 TRF FROM:SAUDI ARABIA 11 ST,11 DIST,1144ZIPCode,RIYADH,KS",NONREF,Transfer,8/12/2024,"163,205.70",,9:39,8/12/2024,"19,425,225.30"
996CT289XE000115,S. A. PARSONS LTD /Bulk Sarie Payments/ TFR+ NATIONAL COMMERCIAL BANK NATIONAL COMMERCIAL BANK EX Rate : SAR 1.0000000 95400005556101 TRF FROM:SAUDI ARABIA CIF-67963529000009,NONREF,Transfer,8/12/2024,"124,978.17",,9:24,8/12/2024,"19,262,019.60"
LP CPMN2W7ZUIRN,"CHARGES SAR 7.00 898571F01RRH T CORP BR 161 JEDDAH TOTAL VAT SAR1,05 ON CHARGE AMOUNT SAR7,",609508,Charges,8/12/2024,,-8.05,1:30,8/12/2024,"19,137,041.43"
LP CPMN2W7ZUIRN,MOHAMMED A. ABDULHALIM A. JABER 898571F01RRH CASH WORKING FUND AL RAJHI BANKING AND INV T CORP BR 161 JEDDAH EX Rate : SAR 1.0000000 AL RAJHI BANKING AND INV,609508,Transfer,8/12/2024,,"-6,567.79",1:30,8/12/2024,"19,137,049.48"
LP CPMN2W7ZTIRN,"CHARGES SAR 7.00 277571G006N7 DOLLAR CLEARING A/C JEDD AH TOTAL VAT SAR1,05 ON CHARGE AMOUNT SAR7,",12588,Charges,8/12/2024,,-8.05,1:30,8/12/2024,"19,143,617.27"
LP CPMN2W7ZTIRN,ALNAFITHA INTERNATIONAL INFO. TEC. 277571G006N7 BANK AL-JAZIRA DOLLAR CLEARING A/C JEDD AH EX Rate : SAR 1.0000000 BANK AL-JAZIRA TRF TO:SAUDI ARABIA,12588,Transfer,8/12/2024,,"-1,000,000.00",1:30,8/12/2024,"19,143,625.32"
LP CPMN2W7ZSIRN,"CHARGES SAR 7.00 655471F01JL3 ALINMA BANK TOTAL VAT SAR1,05 ON CHARGE AMOUNT SAR7,",609537,Charges,8/12/2024,,-8.05,1:30,8/12/2024,"20,143,625.32"
LP CPMN2W7ZSIRN,EXPERT SYSTEMS TRADING COMPANY 655471F01JL3 ALINMA BANK ALINMA BANK EX Rate : SAR 1.0000000 ALINMA BANK TRF TO:SAUDI ARABIA,609537,Transfer,8/12/2024,,"-136,689.00",1:30,8/12/2024,"20,143,633.37"
LP CPMN2W7ZRIRN,"CHARGES SAR 7.00 486571F0201D THE NATIONAL COMMERCIAL BANK TOTAL VAT SAR1,05 ON CHARGE AMOUNT SAR7,",FIN SETT 4356858,Charges,8/12/2024,,-8.05,1:30,8/12/2024,"20,280,322.37"
LP CPMN2W7ZRIRN,ARIJ OSAMA K HAWARI 486571F0201D NATIONAL COMMERCIAL BANK THE NATIONAL COMMERCIAL BANK EX Rate : SAR 1.0000000 NATIONAL COMMERCIAL BANK TRF TO:SAUDI ARABIA,FIN SETT 4356858,Transfer,8/12/2024,,"-128,051.00",1:30,8/12/2024,"20,280,330.42"
LP CPMN2W7ZQIRN,"CHARGES SAR 7.00 262471G01EZ7 ALINMA BANK TOTAL VAT SAR1,05 ON CHARGE AMOUNT SAR7,",609363,Charges,8/12/2024,,-8.05,1:30,8/12/2024,"20,408,381.42"
LP CPMN2W7ZQIRN,DUNCAN AND ROSS ARABIA MANAGEMENT 262471G01EZ7 ALINMA BANK ALINMA BANK EX Rate : SAR 1.0000000 ALINMA BANK TRF TO:SAUDI ARABIA,609363,Transfer,8/12/2024,,"-446,649.42",1:30,8/12/2024,"20,408,389.47"
LP CPMN2W7ZPIRN,"CHARGES SAR 7.00 312371F00GTO THE NATIONAL COMMERCIAL BANK TOTAL VAT SAR1,05 ON CHARGE AMOUNT SAR7,",609438,Charges,8/12/2024,,-8.05,1:30,8/12/2024,"20,855,038.89"
LP CPMN2W7ZPIRN,مؤسسة ابراج اﻻتصاﻻت للمقاوﻻت 312371F00GTO /RFB/ITC INVOICE PAYMENT NATIONAL COMMERCIAL BANK THE NATIONAL COMMERCIAL BANK EX Rate : SAR 1.0000000 NATIONAL COMMERCIAL BANK,609438,Transfer,8/12/2024,,"-284,107.50",1:30,8/12/2024,"20,855,046.94"
LP CPMN2W7ZOIRN,"CHARGES SAR 7.00 187171G004E8 KING ABDUL AZIZ ST ALHOB AR TOTAL VAT SAR1,05 ON CHARGE AMOUNT SAR7,",609557,Charges,8/12/2024,,-8.05,1:30,8/12/2024,"21,139,154.44"
LP CPMN2W7ZOIRN,HUAWEI TECH. INVESTMENT SAUDI ARABI 187171G004E8 /RFB/ITC INVOICE PAYMENT ARAB NATIONAL BANK KING ABDUL AZIZ ST ALHOB AR EX Rate : SAR 1.0000000 ARAB NATIONAL BANK,609557,Transfer,8/12/2024,,"-5,000,000.00",1:30,8/12/2024,"21,139,162.49"
LP CPMN2W7ZNIRN,"CHARGES SAR 7.00 212171F01IGH T CORP BR 161 JEDDAH TOTAL VAT SAR1,05 ON CHARGE AMOUNT SAR7,",609524,Charges,8/12/2024,,-8.05,1:30,8/12/2024,"26,139,162.49"
LP CPMN2W7ZNIRN,شركة برق اﻻولى المحدودة 212171F01IGH AL RAJHI BANKING AND INV T CORP BR 161 JEDDAH EX Rate : SAR 1.0000000 AL RAJHI BANKING AND INV T CORP,609524,Transfer,8/12/2024,,"-561,090.15",1:30,8/12/2024,"26,139,170.54"
LP CPMN2W7ZMIRN,"CHARGES SAR 7.00 046271F01XW1 CORP OPS DIV RIYADH TOTAL VAT SAR1,05 ON CHARGE AMOUNT SAR7,",FIN SETT 4356205,Charges,8/12/2024,,-8.05,1:30,8/12/2024,"26,700,260.69"
LP CPMN2W7ZMIRN,KHALID FAWAZ MOHAMMED ALZAEDI 046271F01XW1 BANQUE SAUDI FRANSI CORP OPS DIV RIYADH EX Rate : SAR 1.0000000,FIN SETT 4356205,Transfer,8/12/2024,,"-20,794.00",1:30,8/12/2024,"26,700,268.74"
LP CPMN2W7ZLIRN,"CHARGES SAR 7.00 154371F01OLG THE NATIONAL COMMERCIAL BANK TOTAL VAT SAR1,05 ON CHARGE AMOUNT SAR7,",609410,Charges,8/12/2024,,-8.05,1:30,8/12/2024,"26,721,062.74"
LP CPMN2W7ZLIRN,طاقم اﻷعمال 154371F01OLG NATIONAL COMMERCIAL BANK THE NATIONAL COMMERCIAL BANK EX Rate : SAR 1.0000000 NATIONAL COMMERCIAL BANK TRF TO:SAUDI ARABIA,609410,Transfer,8/12/2024,,"-436,839.00",1:30,8/12/2024,"26,721,070.79"
LP CPMN2W7ZKIRN,"CHARGES SAR 7.00 181971G00UNN DOLLAR CLEARING A/C JEDD AH TOTAL VAT SAR1,05 ON CHARGE AMOUNT SAR7,",609561,Charges,8/12/2024,,-8.05,1:30,8/12/2024,"27,157,909.79"
LP CPMN2W7ZKIRN,CENTER FOR GOVERNANCE LLC 181971G00UNN BANK AL-JAZIRA DOLLAR CLEARING A/C JEDD AH EX Rate : SAR 1.0000000 BANK AL-JAZIRA TRF TO:SAUDI ARABIA,609561,Transfer,8/12/2024,,"-128,340.00",1:30,8/12/2024,"27,157,917.84"
LP CPMN2W7ZIIRN,"CHARGES SAR 7.00 034271G004FK HEAD OFFICE RIYADH TOTAL VAT SAR1,05 ON CHARGE AMOUNT SAR7,",609382,Charges,8/12/2024,,-8.05,1:30,8/12/2024,"27,286,257.84"
LP CPMN2W7ZIIRN,ALMOKALIDCONTR TRDLTDCO 034271G004FK RIYAD BANK HEAD OFFICE RIYADH EX Rate : SAR 1.0000000 RIYAD BANK TRF TO:SAUDI ARABIA,609382,Transfer,8/12/2024,,"-263,282.24",1:30,8/12/2024,"27,286,265.89"
YRTI-49600,LP IPSP2400KRLAI JAWDAH INDUSTRIAL CO. SA2465000000101156585001 The Saudi Investment Ban k RIYADH 20241207SASIBCSIBC6BCIB11557193977 07DEC24 15:57:43,NONREF,Transfer,8/12/2024,"9,664.82",,15:57,8/12/2024,"27,549,548.13"
SAUDI ARABIAN OI,2000214994 /INV//CNV240831249744 TFR+,2000214994,Transfer,8/12/2024,"63,806.60",,23:36,8/12/2024,"27,539,883.31"
LP IPSP2400KODJE,"20241205SASABBSABB6BNET11927398013 TOT CHG SAR 1.00 NATIONAL COMMERCIAL BANK NATIONAL COMMERCIAL BANK VATABLE SAR 1.00 VAT AMT SAR 0.15 STANDARD RATE AT 000000000000015 TOTAL VAT SAR0,15 ON CHARGE AMOUNT SAR1,",FIN SETT 4356853,Charges,5/12/2024,,-1.15,19:27,5/12/2024,"27,476,076.71"
LP IPSP2400KODJE,YARA YASSER SULAIMAN ALAMMAR 20241205SASABBSABB6BNET11927398013 SA8610000074500001863401NATIONAL COMMERCIAL BANK NATIONAL COMMERCIAL BANKEX Rate SAR 1.0000000,FIN SETT 4356853,Transfer,5/12/2024,,"-8,665.00",19:27,5/12/2024,"27,476,077.86"
347371F0015M,AL SHARIF ABDULLA 050-319557-001,MANUAL 4356201,Transfer,5/12/2024,,"-17,415.62",19:26,5/12/2024,"27,484,742.86"
289071F01MXS,ELAF MED LTD 804-039139-003 /RFB/ITC INVOICE PAYMENT,609289,Transfer,5/12/2024,,"-208,444.40",19:24,5/12/2024,"27,502,158.48"
059071G00Q2X,TATA CONSULTANCY SERVICE 003-520111-001,609188,Transfer,5/12/2024,,"-2,061,334.18",19:24,5/12/2024,"27,710,602.88"
946683400951ZKB2,ركة التلال للحديد المحدودة شركة شخ للحديد المحدودة شركة شخ purchase/Products/Goods TFR+ RIYAD BANK HEAD OFFICE RIYADH EX Rate : SAR 1.0000000 SA6020000001571792309940,NONREF,Transfer,5/12/2024,"23,625.60",,15:57,5/12/2024,"29,771,937.06"
NCBK82424340AXCV,شركة شبكة صحارى TFR+ فواتير خدمات NATIONAL COMMERCIAL BANK NATIONAL COMMERCIAL BANK EX Rate : SAR 1.0000000 65911762000101 TRF FROM:SAUDI ARABIA,NONREF,Transfer,5/12/2024,"229,960.00",,15:36,5/12/2024,"29,748,311.46"
946683400951ZJPK,ركة مدارات التواصل للاتصالات وتقني التواصل للاتصالات وتقني اتير / مصروفات / مشتريات TFR+ من حكم التسوية القضااية الدفعة رقم RIYAD BANK HEAD OFFICE RIYADH,NONREF,Transfer,5/12/2024,"41,816.00",,14:53,5/12/2024,"29,518,351.46"
NCBK82424340AVFS,ليه الغد الدوليه للعلوم الطبيه الت لدوليه للعلوم الطبيه الت مصاريف تشغيل TFR+ فواتير خدمات NATIONAL COMMERCIAL BANK NATIONAL COMMERCIAL BANK EX Rate : SAR 1.0000000,NONREF,Transfer,5/12/2024,"70,000.00",,14:46,5/12/2024,"29,476,535.46"
5.00003E+11,UNICHARM GULF HYGIENIC INDUSTRIES TFR+ AL RAJHI BANKING AND INV T CORP HEAD OFFICE RIYADH EX Rate : SAR 1.0000000 SA5880000362608014488888 TRF FROM:SAUDI ARABIA,NONREF,Transfer,5/12/2024,"65,550.00",,13:48,5/12/2024,"29,406,535.46"
BTPJ-00354,20241205134553 2019702154BLR:090SVR:003 SADAD:5647082442,LIST 109,Transfer,5/12/2024,,-650,13:45,5/12/2024,"29,340,985.46"
BTPX-00355,20241205134546 2558708513BLR:090SVR:003 SADAD:5647082283,LIST 109,Transfer,5/12/2024,,-650,13:45,5/12/2024,"29,341,635.46"
BTPJ-00353,20241205134539 2008295988BLR:090SVR:003 SADAD:5647082132,LIST 109,Transfer,5/12/2024,,-650,13:45,5/12/2024,"29,342,285.46"
BTPV-00349,20241205134347 2023469790BLR:090SVR:007 SADAD:5647079943,LIST 109,Transfer,5/12/2024,,"-6,000.00",13:43,5/12/2024,"29,342,935.46"
946683400951ZHRB,ركة سكيم السعودية العربية شركة شخص لسعودية العربية شركة شخص Purchase/expenses/Utilit TFR+ MULTIPLE INVS INV0005931 RIYAD BANK HEAD OFFICE RIYADH,NONREF,Transfer,5/12/2024,"220,777.55",,13:42,5/12/2024,"29,348,935.46"
BTPX-00339,20241205134041 2470590874BLR:090SVR:003 SADAD:5647070685,LIST 109,Transfer,5/12/2024,,-163,13:40,5/12/2024,"29,128,157.91"
BTPU-00340,20241205134040 2262608520BLR:090SVR:003 SADAD:5647072250,LIST 109,Transfer,5/12/2024,,-163,13:40,5/12/2024,"29,128,320.91"
5.00003E+11,A B V ROCK GROUP COMPANY INTB0230609265040988716E TFR+ AL RAJHI BANKING AND INV T CORP HEAD OFFICE RIYADH EX Rate : SAR 1.0000000 SA9680000504608010988716 TRF FROM:SAUDI ARABIA,NONREF,Transfer,5/12/2024,"200,000.00",,13:20,5/12/2024,"29,128,483.91"
6.55758E+15,YANBU ARAMCO SINOPEC REF TFR+,1.00015E+15,Transfer,5/12/2024,"36,960.00",,13:16,5/12/2024,"28,928,483.91"
6.55758E+15,YANBU ARAMCO SINOPEC REF TFR+,1.00015E+15,Transfer,5/12/2024,"1,016.40",,13:16,5/12/2024,"28,891,523.91"
YRTI-18952,LP IPSP2400KN2MX COMPANY SHOMAH LIMITED SA2280000343608016199917 Alrajhi Bank RIYADH 20241205SARJHIRJHI6BOPF11205889951 05DEC24 12:05:21,NONREF,Transfer,5/12/2024,"5,985.75",,12:05,5/12/2024,"28,890,507.51"
946683400951ZG9M,الجامعة العربية المفتوحة لراتب والمزايا / مصروفات TFR+ انترنت RIYAD BANK HEAD OFFICE RIYADH EX Rate : SAR 1.0000000 SA1320000002330745709945 TRF FROM:SAUDI ARABIA,NONREF,Transfer,5/12/2024,"180,072.75",,11:26,5/12/2024,"28,884,521.76"
946683390951ZCD5,شركة سعيد البقشي للحاسب الالي سعيد البقشي للحاسب الالي Purchase/expenses/Produc TFR+ RIYAD BANK HEAD OFFICE RIYADH EX Rate : SAR 1.0000000 SA7620000003420209859950,NONREF,Transfer,5/12/2024,"123,993.00",,9:57,5/12/2024,"28,704,449.01"
NCBK82424339ASTH,ركه اميال العطاء التجاريه المحدوده العطاء التجاريه المحدوده Operating Expenses TFR+ Service/Utility Bills NATIONAL COMMERCIAL BANK NATIONAL COMMERCIAL BANK EX Rate : SAR 1.0000000,NONREF,Transfer,5/12/2024,"8,750.00",,9:47,5/12/2024,"28,580,456.01"
1604FT24339X91TL,LP CPMN2VU43IRN /DIFF/SABBREM2433900DV,1604FT24339X91TL,Transfer,5/12/2024,290,,9:36,5/12/2024,"28,571,706.01"
EXTN98024339TCY8,LP CPMN2VU4CIRN /INVA/SABBREM2433900DR,EXTN98024339TCY8,Transfer,5/12/2024,290,,9:35,5/12/2024,"28,571,416.01"
P132323641EBPLUS,"SAED INTERNATIONAL FOR ISTIGDAM CO SAED INTERNATIONAL FOR I COMPANIES FOR OTHER PURP TFR+ Payment to Integrates Telecom Compa ny against Invoices 24102125 2409212548721, 240921254875 under P ARAB NATIONAL BANK",NONREF,Transfer,5/12/2024,"64,035.45",,9:29,5/12/2024,"28,571,126.01"
FT24339Y00Z8,1/FIRST ABU DHABI BANK 7702 King fa 1/FIRST ABU DHABI BANK 7 /OPERATIONAL EXPENSES/MI TFR+ FIRST ABU DHABI BANK - K SA FIRST ABU DHABI BANK - K SA,NONREF,Transfer,5/12/2024,"47,868.75",,9:00,5/12/2024,"28,507,090.56"
YRTI-10523,LP IPSP2400KMM5Q الواسع لتقنية المعلومات SA1010000010181015000102 Saudi National Bank JEDDAH 20241205SANCBKNCBK6B82410847567972 05DEC24 08:47:54,NONREF,Transfer,5/12/2024,"18,545.56",,8:47,5/12/2024,"28,459,221.81"
BTBX-00289,FROM AL ELM INFORMATION BTB- BTBX00289241204 ADVANCE PAYMENT,2024024930,Transfer,5/12/2024,"78,453.52",,0:00,5/12/2024,"28,440,676.25"
LP CPMN2VXSOIRN,"CHARGES SAR 7.00 655971E00KYJ HEAD OFFICE RIYADH TOTAL VAT SAR1,05 ON CHARGE AMOUNT SAR7,",609545,Charges,5/12/2024,,-8.05,1:11,5/12/2024,"28,362,222.73"
LP CPMN2VXSOIRN,شركة شبكات المدن 655971E00KYJ ZAWAED AL-TAQA CONT. EST. PRE-2024/16382/009-010-11 RIYAD BANK HEAD OFFICE RIYADH EX Rate : SAR 1.0000000 RIYAD BANK,609545,Transfer,5/12/2024,,"-120,750.00",1:11,5/12/2024,"28,362,230.78"
9.3722E+15,OLIVER WYMAN LIMITED TFR+,9.66005E+12,Transfer,5/12/2024,"103,186.90",,22:33,5/12/2024,"28,482,980.78"
3.7521E+15,OLIVER WYMAN LIMITED TFR+,9.66005E+12,Transfer,5/12/2024,"43,558.17",,22:30,5/12/2024,"28,379,793.88"
1.4572E+15,OLIVER WYMAN LIMITED TFR+,9.66005E+12,Transfer,5/12/2024,"96,995.60",,22:30,5/12/2024,"28,336,235.71"
2.06817E+15,JACOBS COMPANY TFR+,1.3418E+15,Transfer,5/12/2024,"57,500.00",,22:30,5/12/2024,"28,239,240.11"
SAUDI ARABIAN OI,2000210382 /INV//CINV241031273059 TFR+,2000210382,Transfer,5/12/2024,"578,742.10",,22:27,5/12/2024,"28,181,740.11"
ZAD1-50002,CINV24091127 12SEP2024 BS00199467 I24000634H I24000634H,NONREF,Transfer,4/12/2024,"1,242,905.52",,20:04,4/12/2024,"27,602,998.01"
900414INTNDX,WORLEY PARSONS ARABIA LT TFR+ SALAM-ITC/INV/PO''WAL-619/ITC MONTH,PAYMENT NO-2308,Transfer,4/12/2024,"38,197.25",,18:27,4/12/2024,"26,360,092.49"
4.88746E+15,OLIVER WYMAN LIMITED TFR+,9.66005E+12,Transfer,4/12/2024,"43,707.67",,16:41,4/12/2024,"26,321,895.24"
5.00003E+11,MUEEN HUMAN RESOURCES INTB0163974495040110550E TFR+ AL RAJHI BANKING AND INV T CORP HEAD OFFICE RIYADH EX Rate : SAR 1.0000000 SA9280000504608010110550 TRF FROM:SAUDI ARABIA,NONREF,Transfer,4/12/2024,"30,377.25",,16:04,4/12/2024,"26,278,187.57"
946683390951ZB74,الشركة السعودية لتبادل المعلومات لسعودية لتبادل المعلومات أخرى / مشتريات TFR+ 00 48 49 50 51 52 53 54 55 58 RIYAD BANK HEAD OFFICE RIYADH,NONREF,Transfer,4/12/2024,"3,001,901.87",,15:27,4/12/2024,"26,247,810.32"
FT24339047209654,SAR166350001 SETTLEMENT OF BILLS TFR+ INV241011279314U BANK AL BILAD BANK AL BILAD EX Rate : SAR 1.0000000 TRF FROM:SAUDI ARABIA,NONREF,Transfer,4/12/2024,"464,025.00",,15:22,4/12/2024,"23,245,908.45"
YRTI-28541,LP IPSP2400KKW0P world hotel hospitality SA2080000139608016214615 Alrajhi Bank RIYADH 20241204SARJHIRJHI6BOPF11508141087 04DEC24 15:08:15,NONREF,Transfer,4/12/2024,"4,826.55",,15:08,4/12/2024,"22,781,883.45"
188971F01P0I,CAREEM DELEVERIES CO TFR+,GTG-INTEGRATED,Transfer,4/12/2024,"273,931.84",,14:33,4/12/2024,"22,777,056.90"
ECOF41204H000521,ASCENDING PATHS CONTRACTING CO ASCENDING PATHS CONTRACT مصاريف تشغيلية TFR+ 0239 9839سداد الفوا تير BANK AL-JAZIRA HEAD OFFICE JEDDAH EX Rate : SAR 1.0000000,NONREF,Transfer,4/12/2024,"28,290.00",,13:42,4/12/2024,"22,503,125.06"
205071E01IVL,ARABIAN COMPANY FOR AGRC TFR+,INVPAID,Transfer,4/12/2024,"24,561.78",,13:29,4/12/2024,"22,474,835.06"
446971900IRE,"EDARAT CO TFR+ INV231211157692, INV241011197075 INV241011191621",SETTLEMENTS,Transfer,4/12/2024,"14,053.00",,12:08,4/12/2024,"22,450,273.28"
EBBZ-02675,FROM TALAL ABU GHAZALEH يد مستحق لشركة اﻻتصاﻻت المتكاملة,NONREF,Transfer,4/12/2024,"3,450.00",,11:49,4/12/2024,"22,436,220.28"
BTPU-00150,15460601667602 050 15460601667602 SADAD:5644515970,LIST 109,Transfer,4/12/2024,,"-8,500.00",11:19,4/12/2024,"22,432,770.28"
BTPP-00152,19460601752593 050 19460601752593 SADAD:5644515902,LIST 109,Transfer,4/12/2024,,"-4,850.00",11:19,4/12/2024,"22,441,270.28"
BTPM-00150,16460601707473 050 16460601707473 SADAD:5644515856,LIST 109,Transfer,4/12/2024,,"-8,500.00",11:19,4/12/2024,"22,446,120.28"
BTPA-00151,10460501491658 050 10460501491658 SADAD:5644515467,LIST 109,Transfer,4/12/2024,,"-2,425.00",11:19,4/12/2024,"22,454,620.28"
BTPY-00150,17460501491899 050 17460501491899 SADAD:5644515441,LIST 109,Transfer,4/12/2024,,"-2,425.00",11:19,4/12/2024,"22,457,045.28"
BTPW-00152,179400 259 179400 SADAD:5644513856,LIST 109,Transfer,4/12/2024,,-638,11:19,4/12/2024,"22,459,470.28"
BTPU-00149,13460609743300 050 13460609743300 SADAD:5644513820,LIST 109,Transfer,4/12/2024,,"-8,500.00",11:19,4/12/2024,"22,460,108.28"
LP CPM404W06,"CHARGES SAR 7.00 9044LABZR6AT HEAD OFFICE RIYADH TOTAL VAT SAR1,05 ON CHARGE AMOUNT SAR7,",FTTH09884210,Charges,4/12/2024,,-8.05,10:55,4/12/2024,"22,468,608.28"
LP CPM404W06,BASSAM NAHLY 9044LABZR6AT BANQUE SAUDI FRANSI HEAD OFFICE RIYADH EX Rate : SAR 1.0000000,FTTH09884210,Transfer,4/12/2024,,-290,10:55,4/12/2024,"22,468,616.33"
YRTI-15117,LP IPSP2400KK4NW OMLAH EXCHANGE CO SA9360100003695007511001 Bank Aljazira JEDDAH 20241204SABJAZBJAZ2BTMS11042551895 04DEC24 10:43:07,NONREF,Transfer,4/12/2024,"11,068.75",,10:43,4/12/2024,"22,468,906.33"
LP CPMN2VU4FIRN,"CHARGES SAR 7.00 9037TAKUPYXX T CORP BR 161 JEDDAH TOTAL VAT SAR1,05 ON CHARGE AMOUNT SAR7,",RFND181814010,Charges,4/12/2024,,-8.05,10:27,4/12/2024,"22,457,837.58"
LP CPMN2VU4FIRN,ABDULLAH OMAR 9037TAKUPYXX AL RAJHI BANKING AND INV T CORP BR 161 JEDDAH EX Rate : SAR 1.0000000 AL RAJHI BANKING AND INV T CORP,RFND181814010,Transfer,4/12/2024,,-47,10:27,4/12/2024,"22,457,845.63"
LP CPMN2VU4EIRN,"CHARGES SAR 7.00 9057KBRM7RK5 T CORP BR 161 JEDDAH TOTAL VAT SAR1,05 ON CHARGE AMOUNT SAR7,",FTTH07229022,Charges,4/12/2024,,-8.05,10:27,4/12/2024,"22,457,892.63"
LP CPMN2VU4EIRN,MOHAMED GEBRIL 9057KBRM7RK5 AL RAJHI BANKING AND INV T CORP BR 161 JEDDAH EX Rate : SAR 1.0000000 AL RAJHI BANKING AND INV T CORP,FTTH07229022,Transfer,4/12/2024,,-199,10:27,4/12/2024,"22,457,900.68"
LP CPMN2VU4DIRN,"CHARGES SAR 7.00 90450PCRIFTX HEAD OFFICE RIYADH TOTAL VAT SAR1,05 ON CHARGE AMOUNT SAR7,",FTTH09921838,Charges,4/12/2024,,-8.05,10:27,4/12/2024,"22,458,099.68"
LP CPMN2VU4DIRN,KHALED SHAAABIN 90450PCRIFTX RIYAD BANK HEAD OFFICE RIYADH EX Rate : SAR 1.0000000 RIYAD BANK TRF TO:SAUDI ARABIA,FTTH09921838,Transfer,4/12/2024,,-199,10:27,4/12/2024,"22,458,107.73"
LP CPMN2VU4CIRN,"CHARGES SAR 7.00 9049O5Q2RCLH THE NATIONAL COMMERCIAL BANK TOTAL VAT SAR1,05 ON CHARGE AMOUNT SAR7,",FTTH09910346,Charges,4/12/2024,,-8.05,10:27,4/12/2024,"22,458,306.73"
LP CPMN2VU4CIRN,DANILO NONESA 9049O5Q2RCLH NATIONAL COMMERCIAL BANK THE NATIONAL COMMERCIAL BANK EX Rate : SAR 1.0000000 NATIONAL COMMERCIAL BANK TRF TO:SAUDI ARABIA,FTTH09910346,Transfer,4/12/2024,,-290,10:27,4/12/2024,"22,458,314.78"
LP CPMN2VU4BIRN,"CHARGES SAR 7.00 90155A3ZWGPX THE NATIONAL COMMERCIAL BANK TOTAL VAT SAR1,05 ON CHARGE AMOUNT SAR7,",RFND181801201,Charges,4/12/2024,,-8.05,10:27,4/12/2024,"22,458,604.78"
LP CPMN2VU4BIRN,NASSER ALBISHI 90155A3ZWGPX NATIONAL COMMERCIAL BANK THE NATIONAL COMMERCIAL BANK EX Rate : SAR 1.0000000 NATIONAL COMMERCIAL BANK TRF TO:SAUDI ARABIA,RFND181801201,Transfer,4/12/2024,,-230,10:27,4/12/2024,"22,458,612.83"
LP CPMN2VU4AIRN,"CHARGES SAR 7.00 9046L2FOPJJ9 T CORP BR 161 JEDDAH TOTAL VAT SAR1,05 ON CHARGE AMOUNT SAR7,",FTTH08728082,Charges,4/12/2024,,-8.05,10:27,4/12/2024,"22,458,842.83"
LP CPMN2VU4AIRN,HAMAM JAD 9046L2FOPJJ9 AL RAJHI BANKING AND INV T CORP BR 161 JEDDAH EX Rate : SAR 1.0000000 AL RAJHI BANKING AND INV T CORP,FTTH08728082,Transfer,4/12/2024,,-290,10:27,4/12/2024,"22,458,850.88"
LP CPMN2VU49IRN,"CHARGES SAR 7.00 9041F4C937Z9 T CORP BR 161 JEDDAH TOTAL VAT SAR1,05 ON CHARGE AMOUNT SAR7,",FTTH09747801,Charges,4/12/2024,,-8.05,10:27,4/12/2024,"22,459,140.88"
LP CPMN2VU49IRN,MOHAMMED SHABA 9041F4C937Z9 AL RAJHI BANKING AND INV T CORP BR 161 JEDDAH EX Rate : SAR 1.0000000 AL RAJHI BANKING AND INV T CORP,FTTH09747801,Transfer,4/12/2024,,-247,10:27,4/12/2024,"22,459,148.93"
LP CPMN2VU48IRN,"CHARGES SAR 7.00 9061TBGOND1H T CORP BR 161 JEDDAH TOTAL VAT SAR1,05 ON CHARGE AMOUNT SAR7,",FTTH09672808,Charges,4/12/2024,,-8.05,10:27,4/12/2024,"22,459,395.93"
LP CPMN2VU48IRN,MHMD ALHMYDEE 9061TBGOND1H AL RAJHI BANKING AND INV T CORP BR 161 JEDDAH EX Rate : SAR 1.0000000 AL RAJHI BANKING AND INV T CORP,FTTH09672808,Transfer,4/12/2024,,-290,10:27,4/12/2024,"22,459,403.98"
LP CPMN2VU47IRN,"CHARGES SAR 7.00 9039I3ZSSK9X ALINMA BANK TOTAL VAT SAR1,05 ON CHARGE AMOUNT SAR7,",FTTH09471603,Charges,4/12/2024,,-8.05,10:27,4/12/2024,"22,459,693.98"
LP CPMN2VU47IRN,WASFY KAMEL 9039I3ZSSK9X ALINMA BANK ALINMA BANK EX Rate : SAR 1.0000000 ALINMA BANK TRF TO:SAUDI ARABIA,FTTH09471603,Transfer,4/12/2024,,-290,10:27,4/12/2024,"22,459,702.03"
LP CPMN2VU46IRN,"CHARGES SAR 7.00 9060XAFT44SL T CORP BR 161 JEDDAH TOTAL VAT SAR1,05 ON CHARGE AMOUNT SAR7,",FTTH09930942,Charges,4/12/2024,,-8.05,10:27,4/12/2024,"22,459,992.03"
LP CPMN2VU46IRN,MOBIN MUSLEH 9060XAFT44SL AL RAJHI BANKING AND INV T CORP BR 161 JEDDAH EX Rate : SAR 1.0000000 AL RAJHI BANKING AND INV T CORP,FTTH09930942,Transfer,4/12/2024,,-290,10:27,4/12/2024,"22,460,000.08"
LP CPMN2VU45IRN,"CHARGES SAR 7.00 9038P63PSAW5 T CORP BR 161 JEDDAH TOTAL VAT SAR1,05 ON CHARGE AMOUNT SAR7,",FTTH09281203,Charges,4/12/2024,,-8.05,10:27,4/12/2024,"22,460,290.08"
LP CPMN2VU45IRN,KHALID SAEED 9038P63PSAW5 AL RAJHI BANKING AND INV T CORP BR 161 JEDDAH EX Rate : SAR 1.0000000 AL RAJHI BANKING AND INV T CORP,FTTH09281203,Transfer,4/12/2024,,-290,10:27,4/12/2024,"22,460,298.13"
LP CPMN2VU44IRN,"CHARGES SAR 7.00 90590NP6LB5X ALINMA BANK TOTAL VAT SAR1,05 ON CHARGE AMOUNT SAR7,",FTTH09883806,Charges,4/12/2024,,-8.05,10:27,4/12/2024,"22,460,588.13"
LP CPMN2VU44IRN,DANYAL AHMED 90590NP6LB5X ALINMA BANK ALINMA BANK EX Rate : SAR 1.0000000 ALINMA BANK TRF TO:SAUDI ARABIA,FTTH09883806,Transfer,4/12/2024,,-290,10:27,4/12/2024,"22,460,596.18"
LP CPMN2VU43IRN,"CHARGES SAR 7.00 9033P7PANGPX ALINMA BANK TOTAL VAT SAR1,05 ON CHARGE AMOUNT SAR7,",FTTH09695161,Charges,4/12/2024,,-8.05,10:27,4/12/2024,"22,460,886.18"
LP CPMN2VU43IRN,ALSAEED JAD 9033P7PANGPX ALINMA BANK ALINMA BANK EX Rate : SAR 1.0000000 ALINMA BANK TRF TO:SAUDI ARABIA,FTTH09695161,Transfer,4/12/2024,,-290,10:27,4/12/2024,"22,460,894.23"
LP CPMN2VU42IRN,"CHARGES SAR 7.00 9058IA1G679H T CORP BR 161 JEDDAH TOTAL VAT SAR1,05 ON CHARGE AMOUNT SAR7,",FTTH09714044,Charges,4/12/2024,,-8.05,10:27,4/12/2024,"22,461,184.23"
LP CPMN2VU42IRN,SULIMAN ELWAKIL 9058IA1G679H AL RAJHI BANKING AND INV T CORP BR 161 JEDDAH EX Rate : SAR 1.0000000 AL RAJHI BANKING AND INV T CORP,FTTH09714044,Transfer,4/12/2024,,-290,10:27,4/12/2024,"22,461,192.28"
LP CPMN2VU41IRN,"CHARGES SAR 7.00 9031S30RATPH ALINMA BANK TOTAL VAT SAR1,05 ON CHARGE AMOUNT SAR7,",FTTH09637362,Charges,4/12/2024,,-8.05,10:27,4/12/2024,"22,461,482.28"
LP CPMN2VU41IRN,AZZAM ALMALIKI 9031S30RATPH ALINMA BANK ALINMA BANK EX Rate : SAR 1.0000000 ALINMA BANK TRF TO:SAUDI ARABIA,FTTH09637362,Transfer,4/12/2024,,-290,10:27,4/12/2024,"22,461,490.33"
LP CPMN2VU40IRN,"CHARGES SAR 7.00 9055PB7OUBR9 THE NATIONAL COMMERCIAL BANK TOTAL VAT SAR1,05 ON CHARGE AMOUNT SAR7,",FTTH09636297,Charges,4/12/2024,,-8.05,10:27,4/12/2024,"22,461,780.33"
LP CPMN2VU40IRN,ABDULMUTI ALSAQQA 9055PB7OUBR9 NATIONAL COMMERCIAL BANK THE NATIONAL COMMERCIAL BANK EX Rate : SAR 1.0000000 NATIONAL COMMERCIAL BANK TRF TO:SAUDI ARABIA,FTTH09636297,Transfer,4/12/2024,,-290,10:27,4/12/2024,"22,461,788.38"
LP CPMN2VU3ZIRN,"CHARGES SAR 7.00 9029S147C0RP T CORP BR 161 JEDDAH TOTAL VAT SAR1,05 ON CHARGE AMOUNT SAR7,",FTTB09898034,Charges,4/12/2024,,-8.05,10:27,4/12/2024,"22,462,078.38"
LP CPMN2VU3ZIRN,SHUMUKH AL MISBAH COMPANY 9029S147C0RP AL RAJHI BANKING AND INV T CORP BR 161 JEDDAH EX Rate : SAR 1.0000000 AL RAJHI BANKING AND INV T CORP,FTTB09898034,Transfer,4/12/2024,,-290,10:27,4/12/2024,"22,462,086.43"
LP CPMN2VU3YIRN,"CHARGES SAR 7.00 90549BBGW8W5 T CORP BR 161 JEDDAH TOTAL VAT SAR1,05 ON CHARGE AMOUNT SAR7,",FTTH09915536,Charges,4/12/2024,,-8.05,10:27,4/12/2024,"22,462,376.43"
LP CPMN2VU3YIRN,TAYYAB AHMED 90549BBGW8W5 AL RAJHI BANKING AND INV T CORP BR 161 JEDDAH EX Rate : SAR 1.0000000 AL RAJHI BANKING AND INV T CORP,FTTH09915536,Transfer,4/12/2024,,-290,10:27,4/12/2024,"22,462,384.48"
LP CPMN2VU3XIRN,"CHARGES SAR 7.00 9025V11JV885 T CORP BR 161 JEDDAH TOTAL VAT SAR1,05 ON CHARGE AMOUNT SAR7,",FTTH09519694,Charges,4/12/2024,,-8.05,10:27,4/12/2024,"22,462,674.48"
LP CPMN2VU3XIRN,BANNAGA MUSA 9025V11JV885 AL RAJHI BANKING AND INV T CORP BR 161 JEDDAH EX Rate : SAR 1.0000000 AL RAJHI BANKING AND INV T CORP,FTTH09519694,Transfer,4/12/2024,,-290,10:27,4/12/2024,"22,462,682.53"
LP CPMN2VU3WIRN,"CHARGES SAR 7.00 905282KAZ9XH T CORP BR 161 JEDDAH TOTAL VAT SAR1,05 ON CHARGE AMOUNT SAR7,",FTTH09664868,Charges,4/12/2024,,-8.05,10:27,4/12/2024,"22,462,972.53"
LP CPMN2VU3WIRN,KAWTHAR JALQ 905282KAZ9XH AL RAJHI BANKING AND INV T CORP BR 161 JEDDAH EX Rate : SAR 1.0000000 AL RAJHI BANKING AND INV T CORP,FTTH09664868,Transfer,4/12/2024,,-290,10:27,4/12/2024,"22,462,980.58"
LP CPMN2VU3VIRN,"CHARGES SAR 7.00 9022D7EEJ4H1 T CORP BR 161 JEDDAH TOTAL VAT SAR1,05 ON CHARGE AMOUNT SAR7,",FTTH09455121,Charges,4/12/2024,,-8.05,10:27,4/12/2024,"22,463,270.58"
LP CPMN2VU3VIRN,ABBASS ABDELHAMED 9022D7EEJ4H1 AL RAJHI BANKING AND INV T CORP BR 161 JEDDAH EX Rate : SAR 1.0000000 AL RAJHI BANKING AND INV T CORP,FTTH09455121,Transfer,4/12/2024,,-290,10:27,4/12/2024,"22,463,278.63"
9021G2PTMD7P,ELSAKKA MOHAMED 054-215306-150,FTTH09648678,Transfer,4/12/2024,,-290,10:27,4/12/2024,"22,463,568.63"
9018M9FE17VP,KHAWAR AHSAN 181-051913-001,FTTH09927352,Transfer,4/12/2024,,-290,10:27,4/12/2024,"22,463,858.63"
LP CPMN2VU3UIRN,"CHARGES SAR 7.00 9017U7AHUEG5 T CORP BR 161 JEDDAH TOTAL VAT SAR1,05 ON CHARGE AMOUNT SAR7,",FTTH09875537,Charges,4/12/2024,,-8.05,10:27,4/12/2024,"22,464,148.63"
LP CPMN2VU3UIRN,SEDEQ ALQARAH 9017U7AHUEG5 AL RAJHI BANKING AND INV T CORP BR 161 JEDDAH EX Rate : SAR 1.0000000 AL RAJHI BANKING AND INV T CORP,FTTH09875537,Transfer,4/12/2024,,-290,10:27,4/12/2024,"22,464,156.68"
9013F7UP8F8L,ELFARAMAWY MAHMOUD 048-240360-150,FTTH09914312,Transfer,4/12/2024,,-290,10:27,4/12/2024,"22,464,446.68"
LP CPMN2VU3TIRN,"CHARGES SAR 7.00 9012P9AR4EQT DOLLAR CLEARING A/C JEDD AH TOTAL VAT SAR1,05 ON CHARGE AMOUNT SAR7,",FTTH09917541,Charges,4/12/2024,,-8.05,10:27,4/12/2024,"22,464,736.68"
LP CPMN2VU3TIRN,JAMEEL MAQBOOLHUSSAIN 9012P9AR4EQT BANK AL-JAZIRA DOLLAR CLEARING A/C JEDD AH EX Rate : SAR 1.0000000 BANK AL-JAZIRA TRF TO:SAUDI ARABIA,FTTH09917541,Transfer,4/12/2024,,-290,10:27,4/12/2024,"22,464,744.73"
905387LS2PAD,MIKULIK LUKAS 172-034084-001,FTTH09940983,Transfer,4/12/2024,,-870,10:26,4/12/2024,"22,465,034.73"
LP CPMN2VU3GIRN,"CHARGES SAR 7.00 9042BAYA7PGL THE NATIONAL COMMERCIAL BANK TOTAL VAT SAR1,05 ON CHARGE AMOUNT SAR7,",FTTH08736936,Charges,4/12/2024,,-8.05,10:26,4/12/2024,"22,465,904.73"
LP CPMN2VU3GIRN,HASAN ALI AL-ZAHRANI 9042BAYA7PGL NATIONAL COMMERCIAL BANK THE NATIONAL COMMERCIAL BANK EX Rate : SAR 1.0000000 NATIONAL COMMERCIAL BANK TRF TO:SAUDI ARABIA,FTTH08736936,Transfer,4/12/2024,,-870,10:26,4/12/2024,"22,465,912.78"
LP CPMN2VU3FIRN,"CHARGES SAR 7.00 90149846KHT1 T CORP BR 161 JEDDAH TOTAL VAT SAR1,05 ON CHARGE AMOUNT SAR7,",FTTH09949241,Charges,4/12/2024,,-8.05,10:26,4/12/2024,"22,466,782.78"
LP CPMN2VU3FIRN,IZZAT BASAHAI 90149846KHT1 AL RAJHI BANKING AND INV T CORP BR 161 JEDDAH EX Rate : SAR 1.0000000 AL RAJHI BANKING AND INV T CORP,FTTH09949241,Transfer,4/12/2024,,-870,10:26,4/12/2024,"22,466,790.83"
LP CPMN2VU3EIRN,"CHARGES SAR 7.00 9002H28Z2BQD T CORP BR 161 JEDDAH TOTAL VAT SAR1,05 ON CHARGE AMOUNT SAR7,",FTTH09414186,Charges,4/12/2024,,-8.05,10:26,4/12/2024,"22,467,660.83"
LP CPMN2VU3EIRN,AMR ELKADY 9002H28Z2BQD AL RAJHI BANKING AND INV T CORP BR 161 JEDDAH EX Rate : SAR 1.0000000 AL RAJHI BANKING AND INV T CORP,FTTH09414186,Transfer,4/12/2024,,-870,10:26,4/12/2024,"22,467,668.88"
LP CPMN2VU3DIRN,"CHARGES SAR 7.00 9027BBLMNL2D THE NATIONAL COMMERCIAL BANK TOTAL VAT SAR1,05 ON CHARGE AMOUNT SAR7,",FTTH09486857,Charges,4/12/2024,,-8.05,10:26,4/12/2024,"22,468,538.88"
LP CPMN2VU3DIRN,FAHAD ALMOHSEN 9027BBLMNL2D NATIONAL COMMERCIAL BANK THE NATIONAL COMMERCIAL BANK EX Rate : SAR 1.0000000 NATIONAL COMMERCIAL BANK TRF TO:SAUDI ARABIA,FTTH09486857,Transfer,4/12/2024,,"-1,080.00",10:26,4/12/2024,"22,468,546.93"
9001WAHHNJDX,PETER ANTON 353-307580-001,FTTH09946675,Transfer,4/12/2024,,-290,10:26,4/12/2024,"22,469,626.93"
LP CPMN2VU3CIRN,"CHARGES SAR 7.00 9026MAIH9RDX THE NATIONAL COMMERCIAL BANK TOTAL VAT SAR1,05 ON CHARGE AMOUNT SAR7,",FTTH09489013,Charges,4/12/2024,,-8.05,10:26,4/12/2024,"22,469,916.93"
LP CPMN2VU3CIRN,FAHAD ALMOHSEN 9026MAIH9RDX NATIONAL COMMERCIAL BANK THE NATIONAL COMMERCIAL BANK EX Rate : SAR 1.0000000 NATIONAL COMMERCIAL BANK TRF TO:SAUDI ARABIA,FTTH09489013,Transfer,4/12/2024,,"-1,080.00",10:26,4/12/2024,"22,469,924.98"
LP CPMN2VU3BIRN,"CHARGES SAR 7.00 9035A1Q329ET T CORP BR 161 JEDDAH TOTAL VAT SAR1,05 ON CHARGE AMOUNT SAR7,",FTTB09078806,Charges,4/12/2024,,-8.05,10:26,4/12/2024,"22,471,004.98"
LP CPMN2VU3BIRN,ARJWAN AL-SHAM RESTAURANT 9035A1Q329ET AL RAJHI BANKING AND INV T CORP BR 161 JEDDAH EX Rate : SAR 1.0000000 AL RAJHI BANKING AND INV T CORP,FTTB09078806,Transfer,4/12/2024,,-299,10:26,4/12/2024,"22,471,013.03"
LP CPMN2VU3AIRN,"CHARGES SAR 7.00 90082B2LZZ1H THE NATIONAL COMMERCIAL BANK TOTAL VAT SAR1,05 ON CHARGE AMOUNT SAR7,",FTTH09418690,Charges,4/12/2024,,-8.05,10:26,4/12/2024,"22,471,312.03"
LP CPMN2VU3AIRN,ABDULMOHSEN 90082B2LZZ1H NATIONAL COMMERCIAL BANK THE NATIONAL COMMERCIAL BANK EX Rate : SAR 1.0000000 NATIONAL COMMERCIAL BANK TRF TO:SAUDI ARABIA,FTTH09418690,Transfer,4/12/2024,,"-1,450.00",10:26,4/12/2024,"22,471,320.08"
LP CPMN2VU39IRN,"CHARGES SAR 7.00 9034X1VLX6AT T CORP BR 161 JEDDAH TOTAL VAT SAR1,05 ON CHARGE AMOUNT SAR7,",FTTB09084918,Charges,4/12/2024,,-8.05,10:26,4/12/2024,"22,472,770.08"
LP CPMN2VU39IRN,QALAMOUN MEAT BUTCHERY 9034X1VLX6AT AL RAJHI BANKING AND INV T CORP BR 161 JEDDAH EX Rate : SAR 1.0000000 AL RAJHI BANKING AND INV T CORP,FTTB09084918,Transfer,4/12/2024,,-299,10:26,4/12/2024,"22,472,778.13"
LP CPMN2VU38IRN,"CHARGES SAR 7.00 9009HB58852D T CORP BR 161 JEDDAH TOTAL VAT SAR1,05 ON CHARGE AMOUNT SAR7,",FTTH09945563,Charges,4/12/2024,,-8.05,10:26,4/12/2024,"22,473,077.13"
LP CPMN2VU38IRN,MUBAREK OMER 9009HB58852D AL RAJHI BANKING AND INV T CORP BR 161 JEDDAH EX Rate : SAR 1.0000000 AL RAJHI BANKING AND INV T CORP,FTTH09945563,Transfer,4/12/2024,,-290,10:26,4/12/2024,"22,473,085.18"
LP CPMN2VU37IRN,"CHARGES SAR 7.00 9011ZBNVRC4L T CORP BR 161 JEDDAH TOTAL VAT SAR1,05 ON CHARGE AMOUNT SAR7,",FTTH09941467,Charges,4/12/2024,,-8.05,10:26,4/12/2024,"22,473,375.18"
LP CPMN2VU37IRN,SADHANA TIWARI 9011ZBNVRC4L AL RAJHI BANKING AND INV T CORP BR 161 JEDDAH EX Rate : SAR 1.0000000 AL RAJHI BANKING AND INV T CORP,FTTH09941467,Transfer,4/12/2024,,"-1,740.00",10:26,4/12/2024,"22,473,383.23"
LP CPMN2VU36IRN,"CHARGES SAR 7.00 9051K3AGEIYT T CORP BR 161 JEDDAH TOTAL VAT SAR1,05 ON CHARGE AMOUNT SAR7,",FTTH09956226,Charges,4/12/2024,,-8.05,10:26,4/12/2024,"22,475,123.23"
LP CPMN2VU36IRN,MOUSTAFA BARAKAT 9051K3AGEIYT AL RAJHI BANKING AND INV T CORP BR 161 JEDDAH EX Rate : SAR 1.0000000 AL RAJHI BANKING AND INV T CORP,FTTH09956226,Transfer,4/12/2024,,-360,10:26,4/12/2024,"22,475,131.28"
LP CPMN2VU35IRN,"CHARGES SAR 7.00 9006Q7Y3IQHX THE NATIONAL COMMERCIAL BANK TOTAL VAT SAR1,05 ON CHARGE AMOUNT SAR7,",FTTH09905165,Charges,4/12/2024,,-8.05,10:26,4/12/2024,"22,475,491.28"
LP CPMN2VU35IRN,SHAABAN SAMAHA 9006Q7Y3IQHX NATIONAL COMMERCIAL BANK THE NATIONAL COMMERCIAL BANK EX Rate : SAR 1.0000000 NATIONAL COMMERCIAL BANK TRF TO:SAUDI ARABIA,FTTH09905165,Transfer,4/12/2024,,-290,10:26,4/12/2024,"22,475,499.33"
LP CPMN2VU34IRN,"CHARGES SAR 7.00 90104CY2K8X1 T CORP BR 161 JEDDAH TOTAL VAT SAR1,05 ON CHARGE AMOUNT SAR7,",FTTH00200455,Charges,4/12/2024,,-8.05,10:26,4/12/2024,"22,475,789.33"
LP CPMN2VU34IRN,FAHAD BIN HADYAN 90104CY2K8X1 AL RAJHI BANKING AND INV T CORP BR 161 JEDDAH EX Rate : SAR 1.0000000 AL RAJHI BANKING AND INV T CORP,FTTH00200455,Transfer,4/12/2024,,"-1,932.00",10:26,4/12/2024,"22,475,797.38"
LP CPMN2VU33IRN,"CHARGES SAR 7.00 9036KCNDN4X1 T CORP BR 161 JEDDAH TOTAL VAT SAR1,05 ON CHARGE AMOUNT SAR7,",FTTH06011759,Charges,4/12/2024,,-8.05,10:26,4/12/2024,"22,477,729.38"
LP CPMN2VU33IRN,DHIGHAM KHALED ALSHAMMARI 9036KCNDN4X1 AL RAJHI BANKING AND INV T CORP BR 161 JEDDAH EX Rate : SAR 1.0000000 AL RAJHI BANKING AND INV T CORP,FTTH06011759,Transfer,4/12/2024,,-360,10:26,4/12/2024,"22,477,737.43"
LP CPMN2VU32IRN,"CHARGES SAR 7.00 9005F826463P THE NATIONAL COMMERCIAL BANK TOTAL VAT SAR1,05 ON CHARGE AMOUNT SAR7,",FTTH09732693,Charges,4/12/2024,,-8.05,10:26,4/12/2024,"22,478,097.43"
LP CPMN2VU32IRN,RISHAD MOOLACKAL 9005F826463P NATIONAL COMMERCIAL BANK THE NATIONAL COMMERCIAL BANK EX Rate : SAR 1.0000000 NATIONAL COMMERCIAL BANK TRF TO:SAUDI ARABIA,FTTH09732693,Transfer,4/12/2024,,-290,10:26,4/12/2024,"22,478,105.48"
LP CPMN2VU31IRN,"CHARGES SAR 7.00 90200T3EIOKL THE NATIONAL COMMERCIAL BANK TOTAL VAT SAR1,05 ON CHARGE AMOUNT SAR7,",FTTH09924522,Charges,4/12/2024,,-8.05,10:26,4/12/2024,"22,478,395.48"
LP CPMN2VU31IRN,ABDULLH BANGER 90200T3EIOKL NATIONAL COMMERCIAL BANK THE NATIONAL COMMERCIAL BANK EX Rate : SAR 1.0000000 NATIONAL COMMERCIAL BANK TRF TO:SAUDI ARABIA,FTTH09924522,Transfer,4/12/2024,,"-2,200.00",10:26,4/12/2024,"22,478,403.53"
LP CPMN2VU30IRN,"CHARGES SAR 7.00 9030G92UK38L HEAD OFFICE RIYADH TOTAL VAT SAR1,05 ON CHARGE AMOUNT SAR7,",FTTH09644211,Charges,4/12/2024,,-8.05,10:26,4/12/2024,"22,480,603.53"
LP CPMN2VU30IRN,RAFIQUL MIAH 9030G92UK38L RIYAD BANK HEAD OFFICE RIYADH EX Rate : SAR 1.0000000 RIYAD BANK TRF TO:SAUDI ARABIA,FTTH09644211,Transfer,4/12/2024,,-360,10:26,4/12/2024,"22,480,611.58"
LP CPMN2VU2ZIRN,"CHARGES SAR 7.00 9004ZBX4KNAD THE NATIONAL COMMERCIAL BANK TOTAL VAT SAR1,05 ON CHARGE AMOUNT SAR7,",FTTH09707961,Charges,4/12/2024,,-8.05,10:26,4/12/2024,"22,480,971.58"
LP CPMN2VU2ZIRN,ALAA RAYAN 9004ZBX4KNAD NATIONAL COMMERCIAL BANK THE NATIONAL COMMERCIAL BANK EX Rate : SAR 1.0000000 NATIONAL COMMERCIAL BANK TRF TO:SAUDI ARABIA,FTTH09707961,Transfer,4/12/2024,,-290,10:26,4/12/2024,"22,480,979.63"
LP CPMN2VU2YIRN,"CHARGES SAR 7.00 9056WBW251VP THE NATIONAL COMMERCIAL BANK TOTAL VAT SAR1,05 ON CHARGE AMOUNT SAR7,",FTTH09947672,Charges,4/12/2024,,-8.05,10:26,4/12/2024,"22,481,269.63"
LP CPMN2VU2YIRN,ABDULLAH ALHATIM 9056WBW251VP NATIONAL COMMERCIAL BANK THE NATIONAL COMMERCIAL BANK EX Rate : SAR 1.0000000 NATIONAL COMMERCIAL BANK TRF TO:SAUDI ARABIA,FTTH09947672,Transfer,4/12/2024,,"-3,480.00",10:26,4/12/2024,"22,481,277.68"
LP CPMN2VU2XIRN,"CHARGES SAR 7.00 9016F6W3CCO5 THE NATIONAL COMMERCIAL BANK TOTAL VAT SAR1,05 ON CHARGE AMOUNT SAR7,",FTTH09886498,Charges,4/12/2024,,-8.05,10:26,4/12/2024,"22,484,757.68"
LP CPMN2VU2XIRN,AL-EZZI ALSABRI 9016F6W3CCO5 NATIONAL COMMERCIAL BANK THE NATIONAL COMMERCIAL BANK EX Rate : SAR 1.0000000 NATIONAL COMMERCIAL BANK TRF TO:SAUDI ARABIA,FTTH09886498,Transfer,4/12/2024,,-360,10:26,4/12/2024,"22,484,765.73"
LP CPMN2VU2WIRN,"CHARGES SAR 7.00 9003G7X7UZ51 THE NATIONAL COMMERCIAL BANK TOTAL VAT SAR1,05 ON CHARGE AMOUNT SAR7,",FTTH09939883,Charges,4/12/2024,,-8.05,10:26,4/12/2024,"22,485,125.73"
LP CPMN2VU2WIRN,MECIAS III MARI 9003G7X7UZ51 NATIONAL COMMERCIAL BANK THE NATIONAL COMMERCIAL BANK EX Rate : SAR 1.0000000 NATIONAL COMMERCIAL BANK TRF TO:SAUDI ARABIA,FTTH09939883,Transfer,4/12/2024,,-290,10:26,4/12/2024,"22,485,133.78"
90280SODCM05,ALI ABDULKHALQ 003-348083-001,FTTH09858504,Transfer,4/12/2024,,"-3,480.00",10:26,4/12/2024,"22,485,423.78"
9007V8P17KIT,ALABOUDI SULEIMAN 017-261066-001,FTTH09195103,Transfer,4/12/2024,,-360,10:26,4/12/2024,"22,488,903.78"
LP CPMN2VU2VIRN,"CHARGES SAR 7.00 9019W7ONQS6D T CORP BR 161 JEDDAH TOTAL VAT SAR1,05 ON CHARGE AMOUNT SAR7,",FTTH09891173,Charges,4/12/2024,,-8.05,10:26,4/12/2024,"22,489,263.78"
LP CPMN2VU2VIRN,MOHAMMED HAJAJ 9019W7ONQS6D AL RAJHI BANKING AND INV T CORP BR 161 JEDDAH EX Rate : SAR 1.0000000 AL RAJHI BANKING AND INV T CORP,FTTH09891173,Transfer,4/12/2024,,"-4,320.00",10:26,4/12/2024,"22,489,271.83"
LP CPMN2VU2UIRN,"CHARGES SAR 7.00 90406B1D9OV9 T CORP BR 161 JEDDAH TOTAL VAT SAR1,05 ON CHARGE AMOUNT SAR7,",FTTH09230867,Charges,4/12/2024,,-8.05,10:26,4/12/2024,"22,493,591.83"
LP CPMN2VU2UIRN,ABDULQADER ALASMIRE 90406B1D9OV9 AL RAJHI BANKING AND INV T CORP BR 161 JEDDAH EX Rate : SAR 1.0000000 AL RAJHI BANKING AND INV T CORP,FTTH09230867,Transfer,4/12/2024,,-400,10:26,4/12/2024,"22,493,599.88"
LP CPMN2VU2TIRN,"CHARGES SAR 7.00 435871D000Q6 THE NATIONAL COMMERCIAL BANK TOTAL VAT SAR1,05 ON CHARGE AMOUNT SAR7,",MANUAL - 4355878,Charges,4/12/2024,,-8.05,10:26,4/12/2024,"22,493,999.88"
LP CPMN2VU2TIRN,SHAIK ALAUDEEN JAHABAR MARKAR 435871D000Q6 /RFB/GCEO'S ASSISTANT SALARY IN LB NATIONAL COMMERCIAL BANK THE NATIONAL COMMERCIAL BANK EX Rate : SAR 1.0000000 NATIONAL COMMERCIAL BANK,MANUAL - 4355878,Transfer,4/12/2024,,"-6,409.00",10:26,4/12/2024,"22,494,007.93"
LP CPMN2VU2SIRN,"CHARGES SAR 7.00 9024H9FSV5UT T CORP BR 161 JEDDAH TOTAL VAT SAR1,05 ON CHARGE AMOUNT SAR7,",FTTH09210009,Charges,4/12/2024,,-8.05,10:26,4/12/2024,"22,500,416.93"
LP CPMN2VU2SIRN,AZZAM ALOTAIBI 9024H9FSV5UT AL RAJHI BANKING AND INV T CORP BR 161 JEDDAH EX Rate : SAR 1.0000000 AL RAJHI BANKING AND INV T CORP,FTTH09210009,Transfer,4/12/2024,,-400,10:26,4/12/2024,"22,500,424.98"
LP CPMN2VU2RIRN,"CHARGES SAR 7.00 811071D003PX THE NATIONAL COMMERCIAL BANK TOTAL VAT SAR1,05 ON CHARGE AMOUNT SAR7,",MANUAL - 4354699,Charges,4/12/2024,,-8.05,10:26,4/12/2024,"22,500,824.98"
LP CPMN2VU2RIRN,FAHAD MOHAMMED MUSNAD ALOTAIBI 811071D003PX NOV 2024 SALARY ID. NO. 2876 NATIONAL COMMERCIAL BANK THE NATIONAL COMMERCIAL BANK EX Rate : SAR 1.0000000 NATIONAL COMMERCIAL BANK,MANUAL - 4354699,Transfer,4/12/2024,,"-12,569.85",10:26,4/12/2024,"22,500,833.03"
LP CPMN2VU2QIRN,"CHARGES SAR 7.00 9023F4LTT78L T CORP BR 161 JEDDAH TOTAL VAT SAR1,05 ON CHARGE AMOUNT SAR7,",FTTH09715675,Charges,4/12/2024,,-8.05,10:26,4/12/2024,"22,513,402.88"
LP CPMN2VU2QIRN,KHALID HAZAZI 9023F4LTT78L AL RAJHI BANKING AND INV T CORP BR 161 JEDDAH EX Rate : SAR 1.0000000 AL RAJHI BANKING AND INV T CORP,FTTH09715675,Transfer,4/12/2024,,-400,10:26,4/12/2024,"22,513,410.93"
LP CPMN2VU2PIRN,"CHARGES SAR 7.00 9048X175F7R9 T CORP BR 161 JEDDAH TOTAL VAT SAR1,05 ON CHARGE AMOUNT SAR7,",RFND181817591,Charges,4/12/2024,,-8.05,10:26,4/12/2024,"22,513,810.93"
LP CPMN2VU2PIRN,BASHER YOUNES 9048X175F7R9 AL RAJHI BANKING AND INV T CORP BR 161 JEDDAH EX Rate : SAR 1.0000000 AL RAJHI BANKING AND INV T CORP,RFND181817591,Transfer,4/12/2024,,-581.9,10:26,4/12/2024,"22,513,818.98"
LP CPMN2VU2OIRN,"CHARGES SAR 7.00 9050KBVKID51 T CORP BR 161 JEDDAH TOTAL VAT SAR1,05 ON CHARGE AMOUNT SAR7,",FTTH09514797,Charges,4/12/2024,,-8.05,10:26,4/12/2024,"22,514,400.88"
LP CPMN2VU2OIRN,GHAITH ALJULAYGHIM 9050KBVKID51 AL RAJHI BANKING AND INV T CORP BR 161 JEDDAH EX Rate : SAR 1.0000000 AL RAJHI BANKING AND INV T CORP,FTTH09514797,Transfer,4/12/2024,,-707.25,10:26,4/12/2024,"22,514,408.93"
LP CPMN2VU2NIRN,"CHARGES SAR 7.00 90470MGO3LWL T CORP BR 161 JEDDAH TOTAL VAT SAR1,05 ON CHARGE AMOUNT SAR7,",FTTH08481682,Charges,4/12/2024,,-8.05,10:26,4/12/2024,"22,515,116.18"
LP CPMN2VU2NIRN,GHADEER AL HARBI 90470MGO3LWL AL RAJHI BANKING AND INV T CORP BR 161 JEDDAH EX Rate : SAR 1.0000000 AL RAJHI BANKING AND INV T CORP,FTTH08481682,Transfer,4/12/2024,,-707.25,10:26,4/12/2024,"22,515,124.23"
LP CPMN2VU2MIRN,"CHARGES SAR 7.00 9032Y2HCQO6D THE NATIONAL COMMERCIAL BANK TOTAL VAT SAR1,05 ON CHARGE AMOUNT SAR7,",FTTB09869577,Charges,4/12/2024,,-8.05,10:26,4/12/2024,"22,515,831.48"
LP CPMN2VU2MIRN,ETLALET ALWAHA APARTMENTS 9032Y2HCQO6D NATIONAL COMMERCIAL BANK THE NATIONAL COMMERCIAL BANK EX Rate : SAR 1.0000000 NATIONAL COMMERCIAL BANK TRF TO:SAUDI ARABIA,FTTB09869577,Transfer,4/12/2024,,-869,10:26,4/12/2024,"22,515,839.53"
TT CPMN0J4NLIRNN,"CHARGES SAR 130.00 540871E016E3 TOTAL VAT SAR19,5 ON CHARGE AMOUNT SAR130,",609416,Charges,4/12/2024,,-149.5,10:26,4/12/2024,"22,516,708.53"
TT CPMN0J4NLIRNN,BHARTI AIRTEL (HONGKONG) LIMITED 540871E016E3 /RFB/ITC INVOICE PAYMENT EX Rate : SAR 3.7550000 BANK OF AMERICA NA TRF TO:HONG KONG,609416,Transfer,4/12/2024,,"-12,016.00",10:26,4/12/2024,"22,516,858.03"
TT CPMN0J4NKIRNN,"CHARGES SAR 130.00 584771E016V5 TOTAL VAT SAR19,5 ON CHARGE AMOUNT SAR130,",609414,Charges,4/12/2024,,-149.5,10:26,4/12/2024,"22,528,874.03"
TT CPMN0J4NKIRNN,BHARTI INTERNATIONAL (SINGAPORE) PT 584771E016V5 /RFB/ITC INVOICE PAYMENT EX Rate : SAR 3.7550000,609414,Transfer,4/12/2024,,"-13,029.85",10:26,4/12/2024,"22,529,023.53"
TT CPMN0J4NJIRNN,"CHARGES SAR 130.00 126071E017KI TOTAL VAT SAR19,5 ON CHARGE AMOUNT SAR130,",609426,Charges,4/12/2024,,-149.5,10:26,4/12/2024,"22,542,053.38"
TT CPMN0J4NJIRNN,BHARTI INTERNATIONAL (SINGAPORE) PT 126071E017KI /RFB/ITC INVOICE PAYMENT EX Rate : SAR 3.7550000,609426,Transfer,4/12/2024,,"-13,029.85",10:26,4/12/2024,"22,542,202.88"
LP CPMN2VU2LIRN,"CHARGES SAR 7.00 408471D01MSA T CORP BR 161 JEDDAH TOTAL VAT SAR1,05 ON CHARGE AMOUNT SAR7,",MANUAL - 4356188,Charges,4/12/2024,,-8.05,10:26,4/12/2024,"22,555,232.73"
LP CPMN2VU2LIRN,AMGAD ASAMAH D ARAB 408471D01MSA AL RAJHI BANKING AND INV T CORP BR 161 JEDDAH EX Rate : SAR 1.0000000 AL RAJHI BANKING AND INV T CORP,MANUAL - 4356188,Transfer,4/12/2024,,"-25,000.00",10:26,4/12/2024,"22,555,240.78"
LP CPMN2VU2KIRN,"CHARGES SAR 7.00 284071E0174S T CORP BR 161 JEDDAH TOTAL VAT SAR1,05 ON CHARGE AMOUNT SAR7,",609494,Charges,4/12/2024,,-8.05,10:26,4/12/2024,"22,580,240.78"
LP CPMN2VU2KIRN,TAWAFQ 284071E0174S AL RAJHI BANKING AND INV T CORP BR 161 JEDDAH EX Rate : SAR 1.0000000 AL RAJHI BANKING AND INV T CORP,609494,Transfer,4/12/2024,,"-26,255.35",10:26,4/12/2024,"22,580,248.83"
TT CPMN0J4NIIRNN,"CHARGES SAR 130.00 880871E014MD TOTAL VAT SAR19,5 ON CHARGE AMOUNT SAR130,",609444,Charges,4/12/2024,,-149.5,10:26,4/12/2024,"22,606,504.18"
TT CPMN0J4NIIRNN,ORACLE SYSTEMS LTD. 880871E014MD EX Rate : SAR 3.7550000 JPMORGAN CHASE BANK NA TRF TO:SAUDI ARABIA,609444,Transfer,4/12/2024,,"-263,405.51",10:26,4/12/2024,"22,606,653.68"
LP CPMN2VU2JIRN,"CHARGES SAR 7.00 194471E01DB7 ALINMA BANK TOTAL VAT SAR1,05 ON CHARGE AMOUNT SAR7,",609502,Charges,4/12/2024,,-8.05,10:26,4/12/2024,"22,870,059.19"
LP CPMN2VU2JIRN,EXPERT SYSTEMS TRADING COMPANY 194471E01DB7 ALINMA BANK ALINMA BANK EX Rate : SAR 1.0000000 ALINMA BANK TRF TO:SAUDI ARABIA,609502,Transfer,4/12/2024,,"-81,571.80",10:26,4/12/2024,"22,870,067.24"
LP CPMN2VU2IIRN,"CHARGES SAR 7.00 554371E01CCP THE NATIONAL COMMERCIAL BANK TOTAL VAT SAR1,05 ON CHARGE AMOUNT SAR7,",609411,Charges,4/12/2024,,-8.05,10:26,4/12/2024,"22,951,639.04"
LP CPMN2VU2IIRN,QEMMA FOR COLLECTION DEBT CO 554371E01CCP NATIONAL COMMERCIAL BANK THE NATIONAL COMMERCIAL BANK EX Rate : SAR 1.0000000 NATIONAL COMMERCIAL BANK TRF TO:SAUDI ARABIA,609411,Transfer,4/12/2024,,"-149,751.00",10:26,4/12/2024,"22,951,647.09"
TT CPMN0J4NGIRNN,"CHARGES SAR 130.00 157071E011PE TOTAL VAT SAR19,5 ON CHARGE AMOUNT SAR130,",609442,Charges,4/12/2024,,-149.5,10:26,4/12/2024,"23,101,398.09"
TT CPMN0J4NGIRNN,ORACLE SYSTEMS LTD. 157071E011PE EX Rate : SAR 3.7550000 JPMORGAN CHASE BANK NA TRF TO:SAUDI ARABIA,609442,Transfer,4/12/2024,,"-938,750.00",10:26,4/12/2024,"23,101,547.59"
LP CPMN2VU2HIRN,"CHARGES SAR 7.00 281171E01ATM THE NATIONAL COMMERCIAL BANK TOTAL VAT SAR1,05 ON CHARGE AMOUNT SAR7,",609421,Charges,4/12/2024,,-8.05,10:26,4/12/2024,"24,040,297.59"
LP CPMN2VU2HIRN,INTEGRATED POWER FOR TECHNOLOGY 281171E01ATM NATIONAL COMMERCIAL BANK THE NATIONAL COMMERCIAL BANK EX Rate : SAR 1.0000000 NATIONAL COMMERCIAL BANK TRF TO:SAUDI ARABIA,609421,Transfer,4/12/2024,,"-271,320.91",10:26,4/12/2024,"24,040,305.64"
LP CPMN2VU2GIRN,"CHARGES SAR 7.00 198971E010WI JPMorgan Chase Bank Nat Association TOTAL VAT SAR1,05 ON CHARGE AMOUNT SAR7,",609446,Charges,4/12/2024,,-8.05,10:26,4/12/2024,"24,311,626.55"
LP CPMN2VU2GIRN,ORACLE SYSTEMS LTD. 198971E010WI INVOICE NUMBER 1424470 JPMORGAN CHASE BANK NA JPMorgan Chase Bank Nat Association EX Rate : SAR 1.0000000 JPMORGAN CHASE BANK NA,609446,Transfer,4/12/2024,,"-674,445.23",10:26,4/12/2024,"24,311,634.60"
LP CPMN2VU2FIRN,"CHARGES SAR 7.00 807271E014Q5 T CORP BR 161 JEDDAH TOTAL VAT SAR1,05 ON CHARGE AMOUNT SAR7,",609492,Charges,4/12/2024,,-8.05,10:26,4/12/2024,"24,986,079.83"
LP CPMN2VU2FIRN,OPTIMAL TECHNOLOGY SOLUTIONS COMPAN 807271E014Q5 /RFB/ITC INVOICE PAYMENT AL RAJHI BANKING AND INV T CORP BR 161 JEDDAH EX Rate : SAR 1.0000000 AL RAJHI BANKING AND INV,609492,Transfer,4/12/2024,,"-897,000.00",10:26,4/12/2024,"24,986,087.88"
LP CPMN2VU2EIRN,"CHARGES SAR 7.00 502171E017XU T CORP BR 161 JEDDAH TOTAL VAT SAR1,05 ON CHARGE AMOUNT SAR7,",609388,Charges,4/12/2024,,-8.05,10:26,4/12/2024,"25,883,087.88"
LP CPMN2VU2EIRN,AL ANDALUSIA CONTRACTING EST. 502171E017XU /RFB/ITC ADVANCE PAYMENT /RFB/FTTH-ADVANCE AL RAJHI BANKING AND INV T CORP BR 161 JEDDAH EX Rate : SAR 1.0000000,609388,Transfer,4/12/2024,,"-1,026,952.03",10:26,4/12/2024,"25,883,095.93"
LP CPMN2VU2DIRN,"CHARGES SAR 7.00 337571E013JR HEAD OFFICE RIYADH TOTAL VAT SAR1,05 ON CHARGE AMOUNT SAR7,",609493,Charges,4/12/2024,,-8.05,10:26,4/12/2024,"26,910,047.96"
LP CPMN2VU2DIRN,PICO INTERNATIONAL FOR EVENT 337571E013JR RIYAD BANK HEAD OFFICE RIYADH EX Rate : SAR 1.0000000 RIYAD BANK TRF TO:SAUDI ARABIA,609493,Transfer,4/12/2024,,"-1,322,500.00",10:26,4/12/2024,"26,910,056.01"
BTPI-00095,28783720348 020 28783720348 SADAD:5644379989,Nov-24,Transfer,4/12/2024,,-100,10:23,4/12/2024,"28,232,556.01"
NCBK82424339ALHV,ؤسسة توكيلات الباروم التجارية لصاح ات الباروم التجارية لصاح مصاريف تشغيل TFR+ الصيانة التشغيلية NATIONAL COMMERCIAL BANK NATIONAL COMMERCIAL BANK EX Rate : SAR 1.0000000,NONREF,Transfer,4/12/2024,"357,746.45",,10:08,4/12/2024,"28,232,656.01"
010141204H769916,A.M.ALHOKAIR GR FOR TOUR AND DEV A.M.ALHOKAIR GR FOR TOUR MINV00135650 and 51 TFR+ Radisson Blu Jizan SAUDI INVESTMENT BANK RIYADH EX Rate : SAR 1.0000000,NONREF,Transfer,4/12/2024,"27,600.00",,9:49,4/12/2024,"27,874,909.56"
946683380951Z50Y,فندق المنى كريم للايواء السياحي منى كريم للايواء السياحي Purchase/expenses/Produc TFR+ RIYAD BANK HEAD OFFICE RIYADH EX Rate : SAR 1.0000000 SA7420000001142816099944,NONREF,Transfer,4/12/2024,"48,300.00",,9:42,4/12/2024,"27,847,309.56"
EPHR98124339EHUO,ARABIAN GEOPHYSICAL + SURVEYING CO ARABIAN GEOPHYSICAL + SU PVS1 0006174 TFR+ BANQUE SAUDI FRANSI HEAD OFFICE RIYADH EX Rate : SAR 1.0000000 SA5655000000021015203260,NONREF,Transfer,4/12/2024,"209,438.00",,9:29,4/12/2024,"27,799,009.56"
ORB2412027500995,1/PII LIMITED /ROC/9993001092468///URI TFR+ 74775 RIYAD BANK HEAD OFFICE RIYADH EX Rate : SAR 1.0000000 GB79BARC20000070276510 TRF FROM:SAUDI ARABIA,NONREF,Transfer,4/12/2024,"43,670.00",,9:17,4/12/2024,"27,589,571.56"
EC39D0SJ,LANDMARK ARABIA CO. INVP TFR+ BNP PARIBAS SA BNP PARIBAS SA EX Rate : SAR 1.0000000 SA7985476230047700116SAR TRF FROM:SAUDI ARABIA 3005: ALIMAM SAUD IBN ABDULAZIZ: :,NONREF,Transfer,4/12/2024,"199,203.00",,9:15,4/12/2024,"27,545,901.56"
9001FAZEFSD9,SAUDI ARABIAN INS. CO.(S TFR+ COMMUNICATION LINKS INTERNET AND DA TA - 6 MONTHS PAYMENT,355096,Transfer,4/12/2024,"287,529.90",,9:13,4/12/2024,"27,346,698.56"
718071E01ALD,TAWKELAT FOR FINANCING TFR+,MINV00130377,Transfer,4/12/2024,"27,644.52",,9:06,4/12/2024,"27,059,168.66"
YRTI-09582,LP IPSP2400KJOVU ARABIAN ADVANCE SYSTEMS SA6320000002860431149901 Riyad Bank RIYADH 20241204SARIBLRIBL6BTMS10802598155 04DEC24 08:03:10,NONREF,Transfer,4/12/2024,"19,734.00",,8:03,4/12/2024,"27,031,524.14"
EBBC-02901,FROM ALHAMRA FOR INVS CO INV241031276985 INV241031276985,NONREF,Transfer,3/12/2024,"8,280.00",,18:23,3/12/2024,"27,011,790.14"
YRTI-36163,LP IPSP2400KI8XC COMPASS PROJECT CONTRACT SA6265000000101723954001 The Saudi Investment Ban k RIYADH 20241203SASIBCSIBC6BCIB11646121247 03DEC24 16:46:48,NONREF,Transfer,3/12/2024,"16,560.00",,16:46,3/12/2024,"27,003,510.14"
781571D008K8,BEYOT ALARGAN COMPANY TFR+,SALAM,Transfer,3/12/2024,"24,150.00",,16:40,3/12/2024,"26,986,950.14"
208971D009NS,BEYOT ALARGAN COMPANY TFR+,SALAM,Transfer,3/12/2024,"30,898.58",,16:40,3/12/2024,"26,962,800.14"
YRTI-33833,LP IPSP2400KI3G3 شركة ﻻمينا المحدودة SA7880000449608010390002 Alrajhi Bank RIYADH 20241203SARJHIRJHI6BOPF11603079958 03DEC24 16:04:11,NONREF,Transfer,3/12/2024,"10,350.00",,16:04,3/12/2024,"26,931,901.56"
90020EKR2G69,ALITTEFAQ PRODUCT-WORKIN TFR+,25446-5010009584,Transfer,3/12/2024,"217,470.75",,15:29,3/12/2024,"26,921,551.56"
5.00003E+11,AL AYUNI TFR+ AL RAJHI BANKING AND INV T CORP HEAD OFFICE RIYADH EX Rate : SAR 1.0000000 SA7180000504608010104041 TRF FROM:SAUDI ARABIA,NONREF,Transfer,3/12/2024,"61,896.45",,14:43,3/12/2024,"26,704,080.81"
864870U01N20,HERFY FOODS CO. TFR+,2300006248,Transfer,3/12/2024,"374,187.00",,14:27,3/12/2024,"26,642,184.36"
5.00003E+11,OPTIMAL TECHNOLOGY SOLUTION CO OPTIMAL TECHNOLOGY SOLUT INTB0197341064466066666E TFR+ AL RAJHI BANKING AND INV T CORP HEAD OFFICE RIYADH EX Rate : SAR 1.0000000,NONREF,Transfer,3/12/2024,"29,555.00",,13:13,3/12/2024,"26,267,997.36"
YRTI-18465,LP IPSP2400KH2O6 CHILDREN WITH DISABILITI SA1030400108002650000059 Arab National Bank RIYADH 20241203SAARNBARNB1B30011123860795 03DEC24 11:23:29,NONREF,Transfer,3/12/2024,"2,100.00",,11:23,3/12/2024,"26,238,442.36"
1604FT24338Y38XM,CONTROL AND ANTI CORRUPTION AUTHORI CONTROL AND ANTI CORRUPT 23173314600238200 2710 TFR+ SETTLEMENT OF BILL ALINMA BANK ALINMA BANK EX Rate : SAR 1.0000000,NONREF,Transfer,3/12/2024,"173,358.36",,11:17,3/12/2024,"26,236,342.36"
871471600FEW,ABID ALI ALHABASHI TFR+,NONREF,Transfer,3/12/2024,"25,075.05",,10:58,3/12/2024,"26,062,984.00"
1604FT243385MMXM,SAUDI COUNCAL OF ENGINEERS TFR+ 576 هم SETTLEMENT OF BILL ALINMA BANK ALINMA BANK EX Rate : SAR 1.0000000 SA4405000068200000003002,NONREF,Transfer,3/12/2024,"1,030,725.45",,10:21,3/12/2024,"26,037,908.95"
EPHR98124337CTPQ,BANQUE SAUDI FRANSI ACCOUNTS PAYABL TFR+ ntegrated Telecom Company Limited ( BANQUE SAUDI FRANSI HEAD OFFICE RIYADH EX Rate : SAR 1.0000000 20013171 TRF FROM:SAUDI ARABIA,NONREF,Transfer,3/12/2024,"1,041,195.53",,10:21,3/12/2024,"25,007,183.50"
TT CPMN0J2VDIRNN,"CHARGES SAR 130.00 169771C00PZP TOTAL VAT SAR19,5 ON CHARGE AMOUNT SAR130,",MANUAL - 4355462,Charges,3/12/2024,,-149.5,10:18,3/12/2024,"23,965,987.97"
TT CPMN0J2VDIRNN,PCCW CASCADE (MIDDLE EAST) LIMITED 169771C00PZP EX Rate : SAR 3.7550000 HSBC CHINA SERVICES LTD TRF TO:HONG KONG,MANUAL - 4355462,Transfer,3/12/2024,,"-262,850.00",10:18,3/12/2024,"23,966,137.47"
5.00003E+11,EXSA LLTQNEH CO /33/Repayment of Loans TFR+ INTB0065089475810069109E4C039721 AL RAJHI BANKING AND INV T CORP HEAD OFFICE RIYADH EX Rate : SAR 1.0000000 SA4180000581608010069109,NONREF,Transfer,3/12/2024,"73,169.53",,9:45,3/12/2024,"24,228,987.47"
946683370951YZVM,السواعد الكريمة للاستثمار وللتطوير كريمة للاستثمار وللتطوير Purchase/expenses/Hotel TFR+ July to sep 23 RIYAD BANK HEAD OFFICE RIYADH EX Rate : SAR 1.0000000,NONREF,Transfer,3/12/2024,"236,833.23",,9:42,3/12/2024,"24,155,817.94"
NCBK82424337AWYW,ركة عثمان راشد العثمان التجارية شر راشد العثمان التجارية شر Operating Expenses TFR+ Service/Utility Bills NATIONAL COMMERCIAL BANK NATIONAL COMMERCIAL BANK EX Rate : SAR 1.0000000,NONREF,Transfer,3/12/2024,"30,250.75",,9:37,3/12/2024,"23,918,984.71"
NCBK82424337AKVA,ركة خدمات حلول التقنية للاتصالات و حلول التقنية للاتصالات و Operating Expenses TFR+ Service/Utility Bills NATIONAL COMMERCIAL BANK NATIONAL COMMERCIAL BANK EX Rate : SAR 1.0000000,NONREF,Transfer,3/12/2024,"32,000.00",,9:30,3/12/2024,"23,888,733.96"
207071700BBW,DELTA MARKETING CO.L TFR+ DELTA MARKETING COMPANY,PMT/24/07260,Transfer,3/12/2024,"28,497.00",,9:21,3/12/2024,"23,856,733.96"
3.7046E+15,SPERRY SUN SAUDIA COMPAN TFR+,3800060250,Transfer,3/12/2024,"71,346.00",,22:39,3/12/2024,"23,828,236.96"
SAUDI ARABIAN OI,2000201070 /INV//CINV240931263209 TFR+,2000201070,Transfer,3/12/2024,"7,534.80",,22:32,3/12/2024,"23,756,890.96"
EBA8-03992,FROM JUVA MEDIVAL Telecommunication Servic Telecommunication Servic,NONREF,Transfer,2/12/2024,"3,105.00",,15:33,2/12/2024,"23,749,356.16"
855971901FIY,SAUDI CINEMA COMPANY LLC TFR+,2400000763,Transfer,2/12/2024,"250,125.00",,15:03,2/12/2024,"23,746,251.16"
52509FIN021224,FINANCE DIVISION CN240721226289:CINV24102 TFR+ 01/07/2024:01/10/2024 BANK AL-JAZIRA HEAD OFFICE JEDDAH EX Rate : SAR 1.0000000 0800833051682 TRF FROM:SAUDI ARABIA,NONREF,Transfer,2/12/2024,"2,002,726.15",,14:57,2/12/2024,"23,496,126.16"
9008G1U2NXF9,DAR AL RIYADH CONSULTANT TFR+ INV240931262236+198+199,DRCV0648CO,Transfer,2/12/2024,"12,026.77",,14:40,2/12/2024,"21,493,400.01"
DHHD-00017,COL SAMI ALANAZI SALE BSF129406 ID : A 1069174926 DHH 0558557822 TAMIMI CO,NONREF,Cheque,4/12/2024,"291,973.50",,14:21,2/12/2024,"21,481,373.24"
BTBP-00255,FROM SAUDI RAILWAY COMPA BTB- BTBP00255241202,26559,Transfer,2/12/2024,"158,355.00",,14:15,2/12/2024,"21,189,399.74"
BTBN-00255,FROM SAUDI RAILWAY COMPA BTB- BTBN00255241202,26565,Transfer,2/12/2024,"288,592.50",,14:15,2/12/2024,"21,031,044.74"
YRTI-30212,LP IPSP2400KDR8M RAED ABDULSATTAR ALIBRAH SA5655000000099846800135 Banque Saudi Fransi RIYADH 20241202SABSFRBSFR6B98111357267353 02DEC24 13:58:01,NONREF,Transfer,2/12/2024,"1,207.50",,13:58,2/12/2024,"20,742,452.24"
2.6E+11,EJADA SYSTEMS COMPANY LIMITED EJADA SYSTEMS COMPANY LI /A1/Employees Salaries TFR+ AL RAJHI BANKING AND INV T CORP HEAD OFFICE RIYADH EX Rate : SAR 1.0000000,NONREF,Transfer,2/12/2024,"149,040.00",,13:39,2/12/2024,"20,741,244.74"
YRTI-29041,LP IPSP2400KDN99 اﻻتصال الطبية المحدودة SA9810000023657766000110 Saudi National Bank JEDDAH 20241202SANCBKNCBK6B82411337764524 02DEC24 13:37:54,NONREF,Transfer,2/12/2024,"10,350.00",,13:37,2/12/2024,"20,592,204.74"
5.00003E+11,KUN SPORTS COMPANY TFR+ AL RAJHI BANKING AND INV T CORP HEAD OFFICE RIYADH EX Rate : SAR 1.0000000 SA1780000577608010071002 TRF FROM:SAUDI ARABIA,NONREF,Transfer,2/12/2024,"99,000.00",,13:13,2/12/2024,"20,581,854.74"
5.00003E+11,KUN SPORTS COMPANY INTB0242066955770071002E TFR+ AL RAJHI BANKING AND INV T CORP HEAD OFFICE RIYADH EX Rate : SAR 1.0000000 SA1780000577608010071002 TRF FROM:SAUDI ARABIA,NONREF,Transfer,2/12/2024,"20,254.95",,13:10,2/12/2024,"20,482,854.74"
25033802,وزارة المالية TRANSFER TO VENDORN TFR+ Saudi Arabian Monetary A uthority HEAD OFFICE RIYADH EX Rate : SAR 1.0000000 TRF FROM:SAUDI ARABIA,NONREF,Transfer,2/12/2024,"14,135.31",,11:46,2/12/2024,"20,462,599.79"
24876885,وزارة المالية TRANSFER TO VENDORN TFR+ Saudi Arabian Monetary A uthority HEAD OFFICE RIYADH EX Rate : SAR 1.0000000 TRF FROM:SAUDI ARABIA,NONREF,Transfer,2/12/2024,"87,181.76",,11:46,2/12/2024,"20,448,464.48"
24879293,وزارة المالية TRANSFER TO VENDORN TFR+ Saudi Arabian Monetary A uthority HEAD OFFICE RIYADH EX Rate : SAR 1.0000000 TRF FROM:SAUDI ARABIA,NONREF,Transfer,2/12/2024,"29,020.92",,11:34,2/12/2024,"20,361,282.72"
24560921,وزارة المالية TRANSFER TO VENDORN TFR+ Saudi Arabian Monetary A uthority HEAD OFFICE RIYADH EX Rate : SAR 1.0000000 TRF FROM:SAUDI ARABIA,NONREF,Transfer,2/12/2024,"30,701.28",,11:34,2/12/2024,"20,332,261.80"
24560919,وزارة المالية TRANSFER TO VENDORN TFR+ Saudi Arabian Monetary A uthority HEAD OFFICE RIYADH EX Rate : SAR 1.0000000 TRF FROM:SAUDI ARABIA,NONREF,Transfer,2/12/2024,"30,701.28",,11:34,2/12/2024,"20,301,560.52"
211371C00M5A,CATRION CATERING HOLDING TFR+,154113,Transfer,2/12/2024,"85,560.00",,11:33,2/12/2024,"20,270,859.24"
5.00003E+11,MUNIF AMER ABDULLAH ALNAHDE CO MUNIF AMER ABDULLAH ALNA /32/Others TFR+ INTB0204802475770026329E4C025910 AL RAJHI BANKING AND INV T CORP HEAD OFFICE RIYADH,NONREF,Transfer,2/12/2024,"25,000.00",,11:32,2/12/2024,"20,185,299.24"
25046793,وزارة المالية TRANSFER TO VENDORN TFR+ Saudi Arabian Monetary A uthority HEAD OFFICE RIYADH EX Rate : SAR 1.0000000 TRF FROM:SAUDI ARABIA,NONREF,Transfer,2/12/2024,"30,540.00",,11:29,2/12/2024,"20,160,299.24"
25033801,وزارة المالية TRANSFER TO VENDORN TFR+ Saudi Arabian Monetary A uthority HEAD OFFICE RIYADH EX Rate : SAR 1.0000000 TRF FROM:SAUDI ARABIA,NONREF,Transfer,2/12/2024,"94,235.40",,11:25,2/12/2024,"20,129,759.24"
24876884,وزارة المالية TRANSFER TO VENDORN TFR+ Saudi Arabian Monetary A uthority HEAD OFFICE RIYADH EX Rate : SAR 1.0000000 TRF FROM:SAUDI ARABIA,NONREF,Transfer,2/12/2024,"581,211.77",,11:25,2/12/2024,"20,035,523.84"
24879292,وزارة المالية TRANSFER TO VENDORN TFR+ Saudi Arabian Monetary A uthority HEAD OFFICE RIYADH EX Rate : SAR 1.0000000 TRF FROM:SAUDI ARABIA,NONREF,Transfer,2/12/2024,"193,472.82",,11:19,2/12/2024,"19,454,312.07"
24560920,وزارة المالية TRANSFER TO VENDORN TFR+ Saudi Arabian Monetary A uthority HEAD OFFICE RIYADH EX Rate : SAR 1.0000000 TRF FROM:SAUDI ARABIA,NONREF,Transfer,2/12/2024,"204,675.20",,11:19,2/12/2024,"19,260,839.25"
24560918,وزارة المالية TRANSFER TO VENDORN TFR+ Saudi Arabian Monetary A uthority HEAD OFFICE RIYADH EX Rate : SAR 1.0000000 TRF FROM:SAUDI ARABIA,NONREF,Transfer,2/12/2024,"204,675.20",,11:19,2/12/2024,"19,056,164.05"
89847160177S,ELSEWEDY CABLES CO TFR+,NONREF,Transfer,2/12/2024,"79,746.75",,11:15,2/12/2024,"18,851,488.85"
25046792,وزارة المالية TRANSFER TO VENDORN TFR+ Saudi Arabian Monetary A uthority HEAD OFFICE RIYADH EX Rate : SAR 1.0000000 TRF FROM:SAUDI ARABIA,NONREF,Transfer,2/12/2024,"203,600.00",,11:14,2/12/2024,"18,771,742.10"
574771C00SVH,ZAMIL INTL INFO SERV CO. TFR+ /RFB/SETTL. OF INVOICES,ZIIS-FBN-014185,Transfer,2/12/2024,"70,794.00",,11:05,2/12/2024,"18,568,142.10"
NCBK82424337AKPI,ALMABANI GENERAL CON TFR+ Service/Utility Bills NATIONAL COMMERCIAL BANK NATIONAL COMMERCIAL BANK EX Rate : SAR 1.0000000 75400004738108 TRF FROM:SAUDI ARABIA,NONREF,Transfer,2/12/2024,"169,909.65",,10:49,2/12/2024,"18,497,348.10"
1.95702E+13,HUMAN RESOUACES DEVELOPMENT FUND TFR+ ARAB NATIONAL BANK RIYADH BRANCH EX Rate : SAR 1.0000000 UMAN RESOUACES DEVELOPMENT FUND TRF FROM:SAUDI ARABIA 67778 11517,NONREF,Transfer,2/12/2024,"67,130.00",,10:45,2/12/2024,"18,327,438.45"
LPI202433633555,البنك الاسلامى للتنميه ريال نك الاسلامى للتنميه ريال /PAYROLL/ TFR+ SLY AL RAJHI BANKING AND INV T CORP HEAD OFFICE RIYADH EX Rate : SAR 1.0000000,NONREF,Transfer,2/12/2024,"276,697.36",,10:18,2/12/2024,"18,260,308.45"
LP CPMN2VHYZIRN,"CHARGES SAR 7.00 562471C01I4R KING ABDUL AZIZ ST ALHOB AR TOTAL VAT SAR1,05 ON CHARGE AMOUNT SAR7,",609520,Charges,2/12/2024,,-8.05,10:09,2/12/2024,"17,983,611.09"
LP CPMN2VHYZIRN,HUAWEI TECH. INVESTMENT SAUDI ARABI 562471C01I4R /RFB/ITC INVOICE PAYMENT ARAB NATIONAL BANK KING ABDUL AZIZ ST ALHOB AR EX Rate : SAR 1.0000000 ARAB NATIONAL BANK,609520,Transfer,2/12/2024,,"-5,000,000.00",10:09,2/12/2024,"17,983,619.14"
150171C01IJ1,WIPRO ARABIA LTD 042-405787-001,609521,Transfer,2/12/2024,,"-1,000,000.00",10:09,2/12/2024,"22,983,619.14"
LP CPMN2VHYYIRN,"CHARGES SAR 7.00 482971C01HDO CORP OPS DIV RIYADH TOTAL VAT SAR1,05 ON CHARGE AMOUNT SAR7,",609519,Charges,2/12/2024,,-8.05,10:09,2/12/2024,"23,983,619.14"
LP CPMN2VHYYIRN,TECHNICAL LINKS SERVICES COMPANY 482971C01HDO BANQUE SAUDI FRANSI CORP OPS DIV RIYADH EX Rate : SAR 1.0000000 BANQUE SAUDI FRANSI TRF TO:SAUDI ARABIA,609519,Transfer,2/12/2024,,"-5,000,000.00",10:09,2/12/2024,"23,983,627.19"
178671C00HTD,KHALIFA ALGOSAIBI COMPAN TFR+,MINV00139361,Transfer,2/12/2024,"76,560.00",,9:09,2/12/2024,"28,983,627.19"
TT CPMN0IZ3IIRNN,"CHARGES SAR 130.00 205971901F0I TOTAL VAT SAR19,5 ON CHARGE AMOUNT SAR130,",609510,Charges,2/12/2024,,-149.5,6:01,2/12/2024,"28,907,067.19"
TT CPMN0IZ3IIRNN,FTI CONSULTING MEDIA CENTER FZ LLC 205971901F0I EX Rate : SAR 3.7550000 HSBC BANK MIDDLE EAST LT D TRF TO:UNITED ARAB EMIRA TES,609510,Transfer,2/12/2024,,"-2,253,000.00",6:01,2/12/2024,"28,907,216.69"
SAUDI ARABIAN OI,2000196079 /INV//CINV240831251084 TFR+,2000196079,Transfer,2/12/2024,"144,772.35",,23:03,2/12/2024,"31,160,216.69"
265071C00ASI,TAWSEEL FOR TRD CO TFR+,2.0191E+11,Transfer,1/12/2024,"68,082.30",,18:42,1/12/2024,"31,015,444.34"
YRTJ-31039,LP IPSP2400KA9XY RAWABI FOR SMART SERVICE SA8065000000101646964001 The Saudi Investment Ban k RIYADH 20241201SASIBCSIBC4BBRN11441069159 01DEC24 15:20:41,NONREF,Transfer,1/12/2024,"1,531.80",,15:20,1/12/2024,"30,947,362.04"
FT24336122720073,Inventive business solutions compan Inventive business solut SETTLEMENT OF BILLS TFR+ ITC FIRST PAYMENT BANK AL BILAD BANK AL BILAD EX Rate : SAR 1.0000000,NONREF,Transfer,1/12/2024,"277,688.97",,15:18,1/12/2024,"30,945,830.24"
FT24336621187345,Inventive business solutions compan Inventive business solut SETTLEMENT OF BILLS TFR+ ITC SECOND PAYMENT BANK AL BILAD BANK AL BILAD EX Rate : SAR 1.0000000,NONREF,Transfer,1/12/2024,"135,594.28",,15:18,1/12/2024,"30,668,141.27"
NCBK82424336ATDL,شركة مدارس الظهران الأهلية كة مدارس الظهران الأهلية Buying Goods TFR+ Full payment of Finished Goods NATIONAL COMMERCIAL BANK NATIONAL COMMERCIAL BANK EX Rate : SAR 1.0000000,NONREF,Transfer,1/12/2024,"35,903.00",,14:48,1/12/2024,"30,532,546.99"
EBEQ-01271,FROM NEERAAN INTERNATION ITC Payment 2 Goods purchase,NONREF,Transfer,1/12/2024,"10,830.40",,14:38,1/12/2024,"30,496,643.99"
YRTJ-26259,LP IPSP2400K9ZPH ALKHALEEJ FOR TRAINING A SA7320000002090719079952 Riyad Bank RIYADH 20241201SARIBLRIBL6BTMS11417111786 01DEC24 14:17:53,NONREF,Transfer,1/12/2024,"10,522.50",,14:17,1/12/2024,"30,485,813.59"
EPHR98124336AIK8,SAUDI HEALTH SCIENCES COMPANY SAUDI HEALTH SCIENCES CO 20254 شركة الاتصالات TFR+ BANQUE SAUDI FRANSI HEAD OFFICE RIYADH EX Rate : SAR 1.0000000 SA5655000000096751900190,NONREF,Transfer,1/12/2024,"24,777.90",,13:45,1/12/2024,"30,475,291.09"
SDR5-00032,NONREF سالم محمد السويلم ID : B 1057264333,881311,Cash,1/12/2024,,"-16,230.00",13:44,1/12/2024,"30,450,513.19"
SDR5-00031,NONREF سالم محمد السويلم ID : B 1057264333,881312,Cash,1/12/2024,,"-46,201.80",13:41,1/12/2024,"30,466,743.19"
EPHR98124336A87O,SAFARI COMPANY CLOSED JOINT STOCK SAFARI COMPANY CLOSED JO PAYMENT AGAINST PAY R 71 TFR+ BANQUE SAUDI FRANSI HEAD OFFICE RIYADH EX Rate : SAR 1.0000000 SA5655000000050494001064,NONREF,Transfer,1/12/2024,"44,850.00",,11:50,1/12/2024,"30,512,944.99"
YRTJ-14230,LP IPSP2400K97DZ PURE EMERALD SA1830400108057977610016 Arab National Bank RIYADH 20241201SAARNBARNB1B24411141265364 01DEC24 11:41:29,NONREF,Transfer,1/12/2024,"10,516.00",,11:41,1/12/2024,"30,468,094.99"
EPHR981243369ZQV,WAREHOUSING + LOGISTICS SERVICES CO WAREHOUSING + LOGISTICS Settlement of invoices TFR+ BANQUE SAUDI FRANSI HEAD OFFICE RIYADH EX Rate : SAR 1.0000000 SA5655000000053568200142,NONREF,Transfer,1/12/2024,"52,645.41",,10:25,1/12/2024,"30,457,578.99"
4.06272E+11,INTERACTIVE SMART COMPAN 011-810124-001,609518,Transfer,1/12/2024,,"-2,000,000.00",10:25,1/12/2024,"30,404,933.58"
NCBK0912433306YZ,Le Meridian Hotel Company TFR+ فواتير خدمات NATIONAL COMMERCIAL BANK NATIONAL COMMERCIAL BANK EX Rate : SAR 1.0000000 09147159000110 TRF FROM:SAUDI ARABIA,NONREF,Transfer,1/12/2024,"170,775.00",,10:17,1/12/2024,"32,404,933.58"
8359718024PR,RIGNET INC CO. TFR+,INTEGRATED TELEC,Transfer,1/12/2024,"47,150.00",,9:26,1/12/2024,"32,234,158.58"
5.00003E+11,IRADAT S S ALJMAI /33/Repayment of Loans TFR+ INTB0000276261660105500E4C013978 AL RAJHI BANKING AND INV T CORP HEAD OFFICE RIYADH EX Rate : SAR 1.0000000 SA7280000166608010105500,NONREF,Transfer,1/12/2024,"350,524.67",,9:13,1/12/2024,"32,187,008.58"
200GBMS243335108,Nour Internet for Communications an TFR+ CN 279836 285726 GULF INTERNATIONAL BANK BSC RIYADH EX Rate : SAR 1.0000000 SA2390000000020000006305,NONREF,Transfer,1/12/2024,"4,012,606.34",,7:39,1/12/2024,"31,836,483.91"
2144234334FS,1/IAXCESS FZ LLC COMPANY /ROC/2144234334FS///URI/ TFR+ E PAYMENT PURCHASE PAYMENT AGAINST INVOICE JPMORGAN CHASE BANK NA NEW YORK EX Rate : SAR 1.0000000 JO76JKBA2020002870960023002000,NONREF,Transfer,1/12/2024,"26,065.73",,6:01,1/12/2024,"27,823,877.57"
NCBK82424333BARW,شركة ميرال للعيادات الطبية كة ميرال للعيادات الطبية مصاريف تشغيل TFR+ فواتير خدمات NATIONAL COMMERCIAL BANK NATIONAL COMMERCIAL BANK EX Rate : SAR 1.0000000,NONREF,Transfer,1/12/2024,"13,075.50",,2:46,1/12/2024,"27,797,811.84"
1604FT24335NTGWS,FAS THIRD FOR HOTELS CO. 23173280972452103 TFR+ SETTLEMENT OF BILL ALINMA BANK ALINMA BANK EX Rate : SAR 1.0000000 SA5705000068200860175003 TRF FROM:SAUDI ARABIA,NONREF,Transfer,1/12/2024,"25,357.50",,2:44,1/12/2024,"27,784,736.34"
LP CPMN2VATFIRN,"CHARGES SAR 7.00 335771901E1R THE NATIONAL COMMERCIAL BANK TOTAL VAT SAR1,05 ON CHARGE AMOUNT SAR7,",609512,Charges,1/12/2024,,-8.05,1:31,1/12/2024,"27,759,378.84"
LP CPMN2VATFIRN,DAWIYAT INTEGRATED TELECOM 335771901E1R INTEGRATED TELECOM CO. NATIONAL COMMERCIAL BANK THE NATIONAL COMMERCIAL BANK EX Rate : SAR 1.0000000 NATIONAL COMMERCIAL BANK,609512,Transfer,1/12/2024,,"-3,000,000.00",1:31,1/12/2024,"27,759,386.89"
745471701HU8,SAUDI TECHNOLOGY COMPANY TFR+,NONREF,Transfer,1/12/2024,"5,098,525.00",,16:31,1/12/2024,"30,759,386.89"
YRTI-59896,LP IPSP2400K63U9 دية لﻸنظمة اﻻلكترونية SA1805000068202138416000 Alinma bank RIYADH 20241130SAINMAINMA6BXXX11345102346 30NOV24 13:45:37,NONREF,Transfer,1/12/2024,"20,000.00",,13:45,1/12/2024,"25,660,861.89"
SAUDI ARABIAN OI,2000187486 /INV//CINV240931264877 TFR+,2000187486,Transfer,1/12/2024,"136,601.60",,22:45,1/12/2024,"25,640,861.89"
